; 374
##########
###      #
## $ $   #
##.   ## #
##  $ #  #
####@##. #
####### .#
#######$.#
#######  #
##########