; 828
##########
####     #
### . .  #
### $### #
#### @#  #
####$$#  #
####.   .#
#### ##$ #
#######  #
##########