; 587
##########
# .  .   #
# $ $  . #
# $  $##.#
#####    #
#####@## #
######## #
##########
##########
##########