; 55
##########
###  $.###
##.    ###
##$    ###
##  #@ ###
##  #  ###
## . $ ###
##  #  ###
##.$   ###
##########