; 10
##########
######.$  
#   #### #
#      # #
#   @  # #
#   $  # #
#$$#.### #
#..# ### #
####     #
##########