; 482
##########
###     ##
### $@  ##
###   .###
###  #  ##
### $. ###
###  $ ###
###   .$ #
####  .  #
##########