; 150
##########
# .$    .#
# ### # $#
#     #  #
#  @ # ###
#      #.#
#  $   #$#
###.#### #
###      #
##########