; 660
##########
#  $.   .#
# $  .$$.#
# ###  # #
#@########
# ########
##########
##########
##########
##########