; 139
##########
##       #
## ##### #
## @#    #
## #  ####
## # ....#
## # $$$$#
##       #
####     #
##########