; 79
##########
###    $.#
###  #   #
# .$@ #  #
# #   .$ #
#$# ######
#.# ######
##########
##########
##########