; 29
##########
##.$  $.##
##      ##
##   # ###
##   ###.#
##@ $. #$#
###  # # #
###  # # #
###  #   #
##########