; 758
##########
#    #####
#. $ ### #
#..### @ #
#  ###   #
# #####$ #
#      $ #
#   $. # #
##########
##########