; 77
##########
####     #
####$### #
####.# # #
###### # #
# $.   # #
#  # @$. #
#   #  ###
#.$    ###
##########