; 88
##########
#.$ ######
#.$      #
#.$  ##  #
#.$  ### #
#### ### #
#### ### #
#@   ### #
####     #
##########