; 130
##########
####  ####
#.$     ##
#.$ ##@ ##
#       .#
### .   $#
###  ##  #
##  $    #
##      ##
##########