; 145
##########
####.$  ##
####   . #
# #   #  #
#    @# ##
#  $#  $ #
#$ .#    #
#. ##   ##
##     ###
##########