; 629
##########
#     .  #
###$$.   #
###@###  #
###  ## .#
##   ##  #
## $ $   #
###.     #
##########
##########