; 961
##########
##########
##########
######## #
# .  #   #
#.    $ .#
# $$ #   #
## .$#####
### @#####
##########