; 997
##########
#.       #
# $      #
#  ##### #
#   ### .#
#  ####  #
# @ $ ## #
## $ .$  #
#    .   #
##########