; 337
##########
# ########
#. ##### #
#      $ #
# ##   # #
#  ####  #
# $####$ #
#  ####  #
# $. .. @#
##########