; 440
##########
# $  . @ #
#  $ $.$ #
#.  #### #
#   ###  #
## ##### #
##.#######
##########
##########
##########