; 16
##########
####   .##
# @  $   #
#  $#    #
#        #
# ## #   #
#$       #
#  $  ##.#
#..   ####
##########