; 862
##########
# ########
#   ######
# .   $ .#
# $    $@#
#  #######
# ########
#.$ ######
#.  ######
##########