; 9
##########
##########
##########
###   ##.#
###   ##$#
### @$.  #
##    ####
##    $.##
##    $.##
##########