; 871
##########
#######  #
###### $ #
###### $@#
######. ##
#####.. ##
##### $###
#  ## $.##
#       ##
##########