; 542
##########
##   #####
# $   ####
#  #######
#    .####
## $.. ###
#### $####
####.@ $ #
###      #
##########