; 160
##########
##       #
## ##@## #
#. .##   #
#$ $ # ###
#    #   #
#$ $#### #
#. .#### #
##       #
##########