; 32
##########
###.$  ###
######.###
####  $  #
####  @  #
####     #
###.$    #
######  $#
####### .#
##########