; 263
##########
#    #####
#..$ $ $ #
# $ . @. #
# ########
#  #######
# ########
# ########
##########
##########