; 551
##########
#..    ###
# #     ##
#    $ ###
#  #$ ####
# ##  ####
#.###  ###
#  # $####
#  .$@####
##########