; 21
##########
##########
##########
#####.$  #
#.###### #
#$#    # #
#      # #
#.$  @$. #
#####  ###
##########