; 54
##########
#  .$   .#
#  ###  $#
#   @    #
#   $ ####
####.#####
#.$  #####
##########
##########
##########