; 866
##########
#####@####
#### $ ###
#### .  ##
#### $ ###
#####$ ###
#  #   .##
# $#   ###
#  ..   ##
##########