; 28
##########
####...###
#   $$$###
# #      #
#  #.$ # #
## ##### #
## #     #
## # ###@#
##   #####
##########