; 296
##########
#    #####
# $ $#####
# ## #####
#        #
# ..@# $.#
#  # #####
#   $ .###
#     ####
##########