; 604
##########
### . .  #
###      #
###   #  #
####   $ #
##.  # $ #
###  #  ##
###$######
###@$  . #
##########