; 43
##########
#.#.   ###
#$#$ $.###
# #    ###
# ###  ###
# # .$ @##
# # #    #
# # #    #
#   #  ###
##########