; 99
##########
#   @ ####
# $ .   ##
#  #    ##
#    .$ ##
##   ## ##
##      ##
##   $.###
### $.####
##########