; 120
##########
###      #
###.#### #
#  $   #$#
#      #.#
#  @#  ###
#        #
#  ###.$ #
# $.######
##########