; 28
##########
####.$   #
#. ##### #
#$  #    #
#  ##.####
#    $   #
#$       #
#.   @####
##########
##########