; 137
##########
#@##  .. #
#$$      #
#  #$$#  #
# #.  ####
#   # ####
# ########
#.########
##########
##########