; 807
##########
###  . $ #
####   . #
#####.$ ##
#####$ .##
##### $###
######@###
##########
##########
##########