; 534
##########
##########
#. #######
# ########
# #. #####
# $ $@####
# .$ #####
#$ # #####
#      .##
##########