; 652
##########
#######  #
#######$ #
####  @..#
####   $ #
#####$# $#
#### . # #
####  #  #
#     .  #
##########