; 965
##########
##########
##########
##@#######
##$  #####
#   $ $ ##
## $.#   #
#. .### ##
#   .   ##
##########