; 64
##########
###      #
###.####$#
## $   #.#
#  @   ###
# #    ###
# #  $.###
#   ######
#.$ ######
##########