; 250
##########
#    #####
#  #######
# ########
# ########
# ########
#.  $.. ##
# $.$#$ ##
#      @ #
##########