; 24
##########
#######.##
#######$##
##      ##
##.#######
# $   ####
# @      #
#   ##.$ #
######.$ #
##########