; 762
##########
####  ####
###  .   #
###   # .#
### $ # .#
###   #$$#
##    #@ #
##.   # $#
##    #  #
##########