; 298
##########
#. @.#####
# $$######
# $. #####
# #  #####
##  ######
##   # ###
#  $  . ##
#        #
##########