; 557
##########
##     ###
#@$. $.$.#
# $      #
######## #
#######  #
#######  #
########.#
#######  #
##########