; 403
##########
#.  ######
# $$ #####
# #@######
#  $######
# .  #####
## .######
## $ #   #
#       .#
##########