; 648
##########
#    ##  #
# $   #$.#
#  #..   #
# # $ #  #
# $   ####
# ##  ####
# ## .####
#@    ####
##########