; 734
##########
#   ######
#.$ ######
#. #######
#  #######
# $#######
#. #######
#.$  $ ###
# @#   ###
##########