; 474
##########
#.     $@#
#.$ $  $ #
#  .######
#.# ######
### ######
##########
##########
##########
##########