; 898
##########
# ########
#  #######
#  .####@#
# $   .$$#
# #. $ # #
# #####  #
#  #### .#
#        #
##########