; 332
##########
#  .  .  #
#   $ $ ##
#.$#  ####
##@#$ .###
####   ###
##### ####
##### ####
##########
##########