; 100
##########
#.#.$    #
#$###### #
# $.#    #
#  ##.####
#    $   #
#        #
#### @  ##
##########
##########