; 941
##########
####.  . #
###   $$ #
### $ .  #
#######. #
####### ##
####### ##
###### $@#
######   #
##########