; 160
##########
#  $.#.$ #
# ####   #
#    #   #
####.#   #
#   $  $.#
#       ##
##  @  ###
##  ######
##########