; 17
##########
#.$   ####
##       #
#. .     #
# #####  #
#  .$ #  #
# ### #$ #
#   $   #
#     @  #
##########