; 141
##########
##########
##### $.##
##.     ##
## #$  $##
## # # .##
## #  @###
##    $###
##    .###
##########