; 80
##########
##########
##.$     #
##.$  $# #
##.$  .# #
#### ### #
#### ### #
##@  ### #
####     #
##########