; 345
##########
##########
### ##   #
###  $.$ #
###. ##  #
##  ###$ #
##  ###  #
## $##.. #
## @     #
##########