; 825
##########
# ########
# ########
#. # #####
# .  #####
#. $. ####
#  $ #####
#$$#######
# @#######
##########