; 96
##########
##########
###.  ####
### $#####
### . ####
### ######
##..######
# $$ $@# #
#        #
##########