; 15
##########
####     #
#### # #@#
#.$  # ###
#.$  #   #
#    ### #
#      # #
#$$  # # #
#..  #   #
##########