; 736
##########
#@.    ###
# $. $$###
#  #   ###
# ###   ##
#  ##  ###
# ###  .##
#  ##.$ ##
#      ###
##########