; 178
##########
###  $.###
#        #
# $      #
#  ####  #
#  #  @  #
# .      #
#       ##
##.$  $.##
##########