; 174
##########
####### ##
#######  #
#   $ $. #
#        #
## ####$ #
#  ####  #
# $.###  #
##@# ..  #
##########