; 143
##########
####     #
##       #
## # $$$$#
## # ....#
## #  ####
## @#    #
## ##### #
##       #
##########