; 478
##########
#   ######
# $$ #####
#   $@####
# .$ #####
#     ####
#  # #####
# #.  ####
# ..  ####
##########