; 653
##########
# $ ..$  #
#.$    .##
#@$#### ##
#  #######
# ########
#  #######
# ########
#  #######
##########