; 406
##########
#####    #
####  #$ #
####  #..#
##### ## #
#####$ $.#
####     #
#### $   #
#####.  @#
##########