; 591
##########
# ########
# .#.#####
#    #####
#. . #####
# $#######
#    #####
#$$$ #####
# @#######
##########