; 753
##########
####  ####
###  #####
#### #####
# # . ####
#.$  $####
#  # .####
#  $$.####
#  #@#####
##########