; 9
##########
#. #.$   #
#$ ##### #
#     ## #
#     ## #
## @ $.  #
##    ####
##      ##
##    $.##
##########