; 444
##########
##########
##########
##@ ######
##$$######
##  ######
# .$.## .#
#  #  # $#
#     .  #
##########