; 802
##########
#####    #
#### $#  #
#####.# .#
##### ## #
######   #
####@$ $ #
#####.$ .#
#######  #
##########