; 459
##########
# .     ##
#   $ .  #
##  #  . #
#  ##    #
## #######
# $ $ $@##
# .     ##
##########
##########