; 218
##########
#        #
# #   #@ #
# .      #
# $    $ #
#  ####.##
#$ #    ##
#. #$#####
## #.#####
##########