; 46
##########
#.$ $.####
#    #####
#    #####
#    #####
#  @ #####
#  $ ###.#
###.####$#
###      #
##########