; 73
##########
##########
##########
##########
# ########
#  ## ####
# $.@ $ ##
#  #$.$ ##
#   . . ##
##########