; 32
##########
###      #
### .    #
###  ##  #
###  #   #
#.$ $  @ #
#        #
#$   #####
#. $.#####
##########