; 607
##########
##. .$ $ #
## $$  ..#
##  ####@#
##  ###  #
#######  #
#######  #
#######  #
#######  #
##########