; 62
##########
#  ###   #
#.$   $$ #
#   # .  #
#  ## .###
#.$##  ###
#  ### ###
# ########
#@########
##########