; 191
##########
##########
##########
##########
####   ###
#### $$###
#  # .  ##
# $##@$ ##
# .  ..  #
##########