; 4
##########
#....  ###
#$$$$  ###
#        #
#      # #
# ###### #
# #      #
# # ####@#
#   ######
##########