; 177
##########
# ##.$ $.#
# ##.$ $.#
#  ##    #
#   # ## #
# # # ## #
# #   @# #
# ###### #
#        #
##########