; 190
##########
##.$    ##
###  $.###
#.# ######
#$#   @ ##
# ##     #
# ##  $  #
# ####.###
#      ###
##########