; 18
##########
####.$ .##
###### $##
#####   ##
#####   ##
###.#  @ #
###$#  $ #
### ###.##
###     ##
##########