; 15
##########
#     $.##
# ########
# ##   ###
# ##   ###
#  .$@ ###
####    ##
##.$    ##
##.$    ##
##########