; 66
##########
###### $.#
#.####   #
#$#.$  # #
# #    # #
# #   @  #
# #   $ ##
# ####.###
#      ###
##########