; 325
##########
# ..  $@##
# $   $ ##
# .#######
#. #######
#  #######
# $#######
#  #######
# ########
##########