; 465
##########
#.  ######
# $#######
#.   #####
#   $#####
#  .@$. ##
#  #   ###
# $#######
#    #####
##########