; 619
##########
#  #######
# $@######
# $#######
#. .## ###
# $   $ ##
##  . . ##
##########
##########
##########