; 571
##########
####    .#
#######$@#
#######  #
#######$ #
#######  #
#######$ #
######  .#
####.  $.#
##########