; 211
##########
##.$ $.###
#      ###
#### # ###
#  .$ @###
# ##  ####
# ## #####
#$## #####
#.########
##########