; 808
##########
#    @.  #
#. $ # $ #
# $###.  #
#. ##### #
# $#######
#  #######
# ########
##########
##########