; 67
##########
#        #
# ###### #
# #   .#$#
# #   $#.#
# #    ###
# .$@    #
###  ## $#
####    .#
##########