; 22
##########
##. $.####
##$ ######
##   #####
##   #####
# @  #.###
# $  #$###
##.### ###
##     ###
##########