; 838
##########
#   ######
#@.$.  ###
# $. $ ###
# $. #####
# ########
# ########
# ########
##########
##########