; 70
##########
#.$ #.$  #
#   #### #
# #  $.# #
# #    # #
#  @   # #
## $   # #
###.#### #
###      #
##########