; 506
##########
##########
##########
# @#######
#$$ ######
#  ####  #
#  .###$ #
# $ ###  #
#..     .#
##########