; 329
##########
##  .    #
##  #.$  #
### ###  #
###$### $#
###@###  #
#######  #
#######$.#
####### .#
##########