; 667
##########
######  .#
####### $#
####### .#
#######  #
#######. #
####### $#
####  #$ #
#@$     .#
##########