; 178
##########
#######  #
####### $#
#######. #
####### .#
#######$ #
#### $@  #
## #.$ #.#
##       #
##########