; 712
##########
# $. . ###
# ..$$ $@#
## #     #
##########
##########
##########
##########
##########
##########