; 238
##########
##@$    .#
# $     ##
# .####  #
# .#### ##
##$####. #
#  ###  ##
# $###   #
#       ##
##########