; 5
##########
#.$ ######
#   ######
#    $.###
##   #####
## @$. ###
##   # #.#
###### #$#
######   #
##########