; 18
##########
##.#.$  ##
# $  #  ##
#       ##
#      @##
#####    #
#   #  $ #
#$# ###.##
#.#     ##
##########