; 556
##########
##      ##
#    #   #
#   ##  $#
#  ####  #
#  ####. #
# ##### .#
# $@$   ##
# ## $..##
##########