; 221
##########
######  .#
#######$ #
####### .#
#######  #
#######$ #
#######@ #
### . $$ #
####  .  #
##########