; 49
##########
#    #   #
#    # #$#
#.#  # #.#
#$#@$. ###
# #  #####
#   ######
#   ######
#.$ ######
##########