; 792
##########
#  #######
#  #######
# $   . ##
#@#  $.$ #
#  ### $ #
# #### ..#
#  ##### #
#        #
##########