; 24
##########
##########
#  .$  $.#
#        #
#.#   #  #
# $     $#
#    @  .#
# ##### ##
##########
##########