; 632
##########
# ##    @#
#  #.  $ #
# # . #$ #
#.#   #  #
# ## ### #
# ## ##  #
#$$  ##  #
#     .###
##########