; 104
##########
#       ##
# #####$##
#    ##.##
####.#####
#.  $  ###
#$       #
# # @    #
#      $.#
##########