; 73
##########
# ##     #
# .# ### #
# $# $.# #
#  ##### #
#      # #
#   @ $. #
# ##   ###
# $.   ###
##########