; 41
##########
#.$  #####
#        #
##       #
##.      #
##$  ### #
#   $   .#
#@#      #
###   $.##
##########