; 7
##########
##     ###
## . $ ###
##  #  ###
##    @###
##     ###
#      ###
#.$ $#####
#.$ .#####
##########