; 118
##########
##########
####     #
##@# ### #
## # ### #
#    ### #
# ####.. #
#   $.$$ #
#.$      #
##########