; 98
##########
##########
#### @  ##
#        #
#    $   #
#  ##.####
# $.#    #
#$###### #
#.#.$    #
##########