; 180
##########
#      ###
# ####.# #
# #   $  #
# #      #
# ### @# #
# #.#.#  #
# #$#$  $#
#   #   .#
##########