; 144
##########
###      #
##  #### #
## ##@ # #
#. ### # #
#$     # #
#  ### # #
#$ $.# # #
#. $.#   #
##########