; 44
##########
#      ###
# ####.###
# ### $  #
# ### @  #
# $.#    #
#####    #
#####    #
####.$ $.#
##########