; 36
##########
######## #
#######  #
#######$ #
#######  #
####### .#
#######  #
## $ $  .#
#@$ . .  #
##########