; 192
##########
#      ###
# ####.###
#$##  $  #
#.##     #
##### @  #
# .#  #  #
# $##  $.#
#       ##
##########