; 943
##########
#### #  .#
## $ .$$ #
#  .     #
#  #### $#
# #####.@#
# # ######
#      ###
#   #  ###
##########