; 410
##########
### . .$ #
### $@.$ #
##### $# #
#####.   #
#######  #
##########
##########
##########
##########