; 230
##########
###  .####
###$  ####
###  #####
###.$#####
### $ ####
#   @ ####
# $ .#####
#    . ###
##########