; 558
##########
##########
#####  ###
##### ####
##### .###
####. $ ##
#### $ ###
### $.####
#.     $@#
##########