; 525
##########
#. ##    #
#  ###.  #
#.$    $##
#  ###. ##
#@$   $ ##
#  #### ##
######  ##
######  ##
##########