; 494
##########
#######  #
#####@$. #
##### $. #
###### $ #
#######$.#
######  ##
######   #
###### . #
##########