; 605
##########
##########
##########
##########
#####  ###
#.. $  ###
#  $@#  ##
####$$..##
#        #
##########