; 326
##########
##  ######
## $$   ##
##  # $ ##
##  ##   #
##   ##  #
### ### .#
##@   .#$#
##.     .#
##########