; 133
##########
###      #
###.  .$ #
#######  #
#######$.#
#######. #
#######  #
###### $$#
######@  #
##########