; 59
##########
#    #####
# # .. ###
# $    ###
#   #$ ###
# ###   ##
#  ###  ##
# $#   ###
# .$ @. ##
##########