; 867
##########
#@$  .  ##
# $  #####
# ########
# ########
#    #####
# .$######
#. $ #####
# .  #####
##########