; 373
##########
##########
##########
##########
##########
# . ######
#.  ######
# $$. $ ##
#     .$@#
##########