; 316
##########
#        #
# $   @$ #
# # ###..#
# $  .#  #
# # $ # .#
####  #  #
###   ####
###   ####
##########