; 350
##########
###    . #
### $ #  #
#### ## $#
####. #. #
#### ##$ #
###   #  #
###   #$.#
#    ##@ #
##########