; 233
##########
###@.   ##
#### #$$##
######  ##
#######  #
#######  #
####### ##
#  $  $ .#
# . .    #
##########