; 105
##########
##########
###  . ###
#@$ .$$ ##
###  #  ##
#####   ##
### #$  ##
###.    ##
### # .  #
##########