; 176
##########
#..      #
#$$ #### #
#   ##@# #
#$$    # #
#..### # #
####   # #
###  ### #
#        #
##########