; 230
##########
###   $.##
####    ##
#####@  .#
####  # $#
##   $   #
#####.####
##### ####
#.$   ####
##########