; 678
##########
# .. #####
# .  #####
#   ######
#.$ ######
# # ######
#$$$@#####
#    #####
##########
##########