; 38
##########
#  #  .###
#  # $ $ #
#  # . . #
# ## $####
# ##  ####
#  #  .###
# ###$ ###
#     @###
##########