; 105
##########
#  $.#   #
# #  # # #
#    # # #
# @ $. # #
#    ### #
#    ### #
#$  ##.$ #
#.  ######
##########