; 49
##########
###.$  ###
###    .##
###    $##
### @#  ##
###  #  ##
### $ . ##
###  #  ##
###   $.##
##########