; 210
##########
##       #
##  # # $#
#######@ #
#######  #
######## #
####### .#
# $ $  $ #
#  .  .. #
##########