; 18
##########
####.$ .##
###### $##
#   #   ##
# # #   ##
# # #  @ #
#$# #  $ #
#.# ###.##
###     ##
##########