; 21
##########
#   .    #
# $      #
###. ### #
####  # .#
## @ ### #
#. $ #####
# $$ #####
##       #
##########