; 761
##########
# $  . . #
#    $   #
#  ##### #
# . ###  #
# $  .#  #
#  #$ #@ #
####   ###
##### ####
##########