; 72
##########
###  $.###
###.######
#  $   ###
#  @ #####
# #  #####
#  #.#####
#$  $#####
#.   #####
##########