; 140
##########
#      ###
# ####.###
# #   $ ##
# ##    ##
# $.# @  #
##### ## #
#    .$  #
# $.     #
##########