; 87
##########
###  ## .#
###     $#
# .$ @   #
# #      #
# #  ### #
# ####.# #
#    #$#$#
####   #.#
##########