; 78
##########
#        #
##.$   #$#
#####  #.#
#   # @  #
# #$#    #
# #.# $  #
# ####.###
#      ###
##########