; 381
##########
#####    #
#####... #
#####  ###
#####  ###
#####.$ ##
####   $@#
#####$$ ##
####     #
##########