; 39
##########
#####   .#
#     $  #
#   $    #
# $ # $ @#
#$ ###  ##
#  . ##.##
#  $   .##
#.     .##
##########