; 197
##########
#.   #####
#  .######
# $ ######
#@$  #####
#$$  #####
# ..######
##########
##########
##########