; 883
##########
# $ .   ##
#@$.$    #
#######..#
####### $#
#######  #
##########
##########
##########
##########