; 222
##########
##########
##########
##########
##  ##  .#
##.$    $#
#  ## .$ #
#  # $# .#
##@   ## #
##########