; 590
##########
#    .  ##
# $ . $###
# #$   $ #
#.#  #. @#
##########
##########
##########
##########
##########