; 716
##########
# $   . .#
#@ # .$  #
#######  #
###### $.#
######   #
#######$ #
#######  #
######## #
##########