; 71
##########
#   ## $.#
#    #   #
# #    # #
#.#    # #
# $ # @# #
#   # ## #
#        #
#.$    $.#
##########