; 139
##########
##########
##.$ #####
##     .##
##$  $# ##
##. # # ##
###@  # ##
###$    ##
###.    ##
##########