; 980
##########
##########
####. #  #
# $@   $ #
# .   #  #
# $ #.## #
# $ #    #
# .###   #
######## #
##########