; 654
##########
# @#######
#$$. #####
# . ######
#  .######
#.$$######
#   ######
# ########
# ########
##########