; 920
##########
######. .#
###@$ $$ #
#### .   #
####  #$ #
####.##  #
######## #
##########
##########
##########