; 472
##########
# $.######
#  #######
# ########
#@ #######
# ### #.##
# $ .    #
#   $. $ #
#    #####
##########