; 2
##########
##########
##########
###  @   #
###    $ #
#.$   #  #
#      . #
#$$      #
#.. ######
##########