; 606
##########
#@ #######
# $##   ##
#   ##  ##
# $.   ###
# $.$  ###
# ###  ###
#  ##. ###
#    .  ##
##########