; 848
##########
#@$.  .$.#
# $    $ #
######.  #
##########
##########
##########
##########
##########
##########