; 54
##########
#  .$   .#
#  ###  $#
#   @    #
#   $ ####
####.#####
#    #####
# ########
# $.######
##########