; 120
##########
###      #
#   $.$$ #
# ####.. #
#    #.$ #
#@# #### #
### #    #
### # #  #
###     ##
##########