; 408
##########
# $  .   #
#@. .$ $ #
# $#######
#  #######
# ########
# ########
#.### ####
#     ####
##########