; 155
##########
#.# $.   #
#$#    $.#
# #      #
# ###  # #
# # .$ @ #
# # #  # #
# # #    #
#   #    #
##########