; 43
##########
##########
##########
#.########
#$######.#
# #     $#
# .$@    #
###     $#
###     .#
##########