; 168
##########
##     $.#
#        #
#   #. ###
#  ###  ##
#  ###$ ##
#        #
#.$ @    #
######.$ #
##########