; 126
##########
##########
#.  .$   #
#$#     $#
#     $ .#
##   # ###
##  @#.###
##     ###
##     ###
##########