; 451
##########
##@  #####
##$$######
##   #####
##. ######
##   #####
# $ ######
#.$ ### ##
#  . .  ##
##########