; 4
##########
##########
##########
###.#  $.#
###$#.####
###  $ ###
#    @ ###
#$     ###
#.  ######
##########