; 176
##########
##.$  $.##
##       #
#      . #
#  @  #  #
#  ####  #
#      $ #
#        #
###.$  ###
##########