; 117
##########
##       #
## ###.$ #
## ###.$ #
## ####. #
##    #$ #
##### #  #
###@  # $#
#####   .#
##########