; 901
##########
########@#
########$#
######.# #
#### #   #
#### #   #
###  .#..#
### $$ $ #
###      #
##########