; 682
##########
#    .####
# $ $ ####
# $ #  ###
# @#  ####
#  .# ####
# $ ######
# .#######
#. #######
##########