; 804
##########
#   ###  #
# $####$ #
#  # ##  #
#    $ $@#
#  #. ...#
######   #
###### # #
##########
##########