; 253
##########
#####    #
## $ $ ..#
##@$   $ #
######## #
####### .#
#######  #
###   # .#
#        #
##########