; 33
##########
###.$  ###
###.$  ###
###.$    #
####.$ # #
### ## # #
#@     # #
### #### #
###      #
##########