; 62
##########
#.$ ##.$ #
#        #
#   @   ##
#   $  ###
####.#####
#    #####
# ########
# $.######
##########