; 684
##########
##########
##########
##########
#  .##  ##
#.$    ###
#.   $ # #
#### .$$ #
####  @  #
##########