; 763
##########
##########
##########
##########
##########
#######  #
#### $  .#
####.$$. #
###@$  . #
##########