; 570
##########
###      #
### $    #
########.#
# . ###  #
# $@###$ #
#   ###  #
##$ ###. #
## .     #
##########