; 60
##########
##.$     #
######## #
#####    #
#####.####
###  $   #
##   @   #
#        #
# $.## $.#
##########