; 31
##########
#####   ##
### .$@ ##
### #   ##
###$#  ###
###.#  ###
###### ..#
###### $$#
######   #
##########