; 249
##########
#       ##
# $ $ $###
# ###  ###
# ####@###
# ####.  #
#####  # #
#####. $ #
###.   . #
##########