; 58
##########
# $.## $.#
#        #
##   @   #
###  $   #
#####.####
#####  $.#
##########
##########
##########