; 796
##########
#.   . $ #
# $    $.#
####### .#
#######$ #
#######@ #
##########
##########
##########
##########