; 539
##########
#  @    ##
# $    $ #
####  #  #
####  ## #
####.    #
##### .$ #
##### .$.#
#######  #
##########