; 171
##########
#      $.#
# ########
# #     .#
# #   # $#
# #   #  #
# .$ @#  #
###  ## $#
####    .#
##########