; 659
##########
##########
# ########
# ########
#  #######
#. #######
#.. $  $@#
#$$ #   ##
#  .######
##########