; 116
##########
##########
#    #####
# $ @ .###
#  ### ###
#       .#
#.$   $ $#
######.  #
##########
##########