; 79
##########
####### ##
#######  #
#######. #
####### $#
#  #### .#
#.$@###$ #
## $# #  #
##      .#
##########