; 27
##########
##   #####
## #     #
##  #### #
#.$ .#   #
#.$ $# ###
#.$  # ###
### ## ###
###    @##
##########