; 229
##########
# ##  ####
#  #.$####
# $  . ###
# $  $ ###
# @#. ####
# ########
#.########
##########
##########