; 905
##########
#####    #
##### .$ #
#######  #
####@ ##.#
####$###.#
####  #  #
### . $ $#
###      #
##########