; 42
##########
####.$ $.#
#####    #
#   #    #
# # #    #
# #$# @  #
# #.# $  #
# ####.###
#      ###
##########