; 386
##########
##########
# ########
#@########
# ########
# ##.#####
# ## $ ###
# $  $  ##
# $..  .##
##########