; 5
##########
#.$ #.$  #
#   #### #
#    $.# #
##   ### #
## @$. # #
##   # # #
###### # #
######   #
##########