; 670
##########
#     . ##
# $ ##.$##
#  ### $ #
# ####@  #
# ##     #
# . $ . ##
#  #   ###
#####  ###
##########