; 68
##########
#      ###
# ####.###
# #   $ ##
# #   @  #
# #    # #
#$#.$  # #
#.####   #
###### $.#
##########