; 380
##########
#  ####  #
# $ ###  #
#.  #### #
# . ###  #
# . ###$ #
#  #### @#
#$$# ##  #
#.       #
##########