; 48
##########
#####    #
##### ## #
##    ##$#
##.#####.#
# $   ####
#       .#
# @#    $#
#  ##.$  #
##########