; 433
##########
##########
##########
########@#
########$#
#        #
# $#   $ #
#.$.###  #
#  .    .#
##########