; 46
##########
#    .####
#     ####
# #  $ .##
# ##   $ #
#.## @   #
###   $ .#
#  $  ####
#    #####
##########