; 171
##########
#. ###   #
#$ #    $#
#    $  .#
#  .##  ##
#  ### @##
#   ##  ##
#      $##
##     .##
##########