; 196
##########
#        #
#$ ## .$ #
#. ## ####
## .$    #
#     #@ #
# $      #
# #####  #
#.       #
##########