; 134
##########
####  ####
##     $.#
## @## $.#
#.       #
#$   . ###
#  ##  ###
#    $  ##
##      ##
##########