; 33
##########
##.$   ###
######   #
###.#### #
###$   # #
###    # #
##   @$. #
#      ###
#.$    ###
##########