; 65
##########
#.$ ##   #
#   #    #
# #    # #
# #    #.#
# #@ # $ #
# ## #   #
#        #
#.$    $.#
##########