; 13
##########
##    $.##
##    $.##
##    ####
### @$.  #
###   ## #
#.#   ## #
#$###### #
#        #
# ########