; 391
##########
##### ##.#
#####    #
####.  . #
####   ###
#####$####
#  ##  ###
# $ $$ ###
# @ .    #
##########