; 671
##########
# .@    .#
## $ $.$$#
#####  #.#
##########
##########
##########
##########
##########
##########