; 68
##########
####   $.#
#### # $.#
#    # $.#
# ## # $.#
#  #@#   #
#  ###   #
#  ####  #
#        #
##########