; 165
##########
##   @####
##      ##
##    $ ##
##  ###. #
#   ###  #
#       $#
#$$     .#
#..  #####
##########