; 740
##########
#        #
# $  $ . #
#  ##### #
# #####  #
# @####$ #
# ##### .#
#    . $ #
#     # .#
##########