; 779
##########
### .  ###
#@     ###
## #.   ##
#####.$$##
##### $  #
######   #
#####  $ #
####  . ##
##########