; 12
##########
####     #
#..# ### #
#$$#.### #
#   $  # #
#   @  # #
#      # #
#   #### #
######.$  #
##########