; 266
##########
#      ###
# $ #  ###
#   #  ###
# $ ##.###
#  $#  ###
# . @. ###
# #$#   ##
##  .  ###
##########