; 106
##########
##### .  #
#####  ..#
######$$ #
######   #
##### $  #
######@ .#
######$  #
######   #
##########