; 153
##########
######   #
#######. #
####.    #
####  #  #
## ## #.##
#.  $$$$ #
#   # @ ##
# ########
##########