; 97
##########
####.$ ###
###.$   ##
##      ##
## ##   ##
## $.    #
##    #  #
##   . $ #
#### @   #
##########