; 25
##########
##   #####
## @$. ###
##   # ###
###  # ###
###  # ###
#.. ## ###
#$$ ## $.#
#   ######
##########