; 723
##########
#.       #
# $$.. $ #
#  #######
# ########
#  $@#####
#    #####
# ########
#. #######
##########