; 861
##########
###  ### #
### $  $ #
### $   .#
###  ##  #
#  @. #  #
# #.#### #
#######  #
###.   $ #
##########