; 493
##########
# .$  .  #
# $.# #  #
# $ ###  #
# @##### #
#.$ #### #
#  ####  #
#######  #
####### ##
##########