; 823
##########
##########
### ######
#  . .####
###$ #####
# #   ####
#. $  ####
# .$ $ ###
#     @###
##########