; 18
##########
####.$ .##
###### $##
#####   ##
#####   ##
#####  @ #
#####  $ #
#######.##
####.$  ##
##########