; 11
##########
######## #
#######. #
#######  #
## .###$@#
#   $ #  #
#     #$ #
#####  $ #
#### . . #
##########