; 690
##########
###.     #
### $ .. #
### $   ##
######$###
#####   ##
##### .###
##### $###
#@     ###
##########