; 196
##########
#    #   #
# ##   # #
# ###### #
#        #
#$ $.### #
#. $.###@#
## $.#####
##########
##########