; 15
##########
#   $.# .#
# ##### $#
# ##     #
# ##     #
#  .$ @ ##
####    ##
##      ##
##.$    ##
##########