; 362
##########
## @ .####
# $ ######
# .$######
# $ ######
##. ######
## #######
#  $  ####
#      . #
##########