; 457
##########
#######  #
#######. #
##@$  $$ #
###  .   #
#### ##  #
###  ### #
## $ ### #
#     . .#
##########