; 55
##########
#.$ $.####
#.$ $.####
#    #####
# ## #####
#  # #####
## #   @##
##  ## ###
###    ###
##########