; 924
##########
# ########
#.########
#.########
#@ #######
# ########
# . $ ####
# $$$. # #
#        #
##########