; 11
##########
##.$    ##
##      ##
####    ##
#  .$ @ ##
# ##     #
# ##     #
# ##### $#
#   $.# .#
##########