; 74
##########
#####   .#
#####$  $#
#####.#  #
# $.#  # #
# ### @  #
# #   $  #
# ####.###
#      ###
##########