; 56
##########
# $.######
# ########
#    #####
####.#####
#   $  ###
#   @   ##
#        #
#.$ ##.$ #
##########