; 853
##########
##@ .    #
##.$ $ $$#
####### .#
#######. #
#######  #
##########
##########
##########
##########