; 21
##########
##########
##########
##########
#.######.#
#$#    #$#
#      # #
#.$  @$. #
#####  ###
##########