; 215
##########
#  . .  ##
# $ $ ####
##$ ######
##   #####
###  #####
##  ######
## .######
##.$@#####
##########