; 220
##########
## #.#####
#. #$#####
#$ #    ##
#  ####.##
# $    $ #
# .      #
# #   #@ #
#        #
##########