; 368
##########
######   #
######.$ #
#######  #
########.#
#######  #
##  ###$ #
#.$.$    #
# @      #
##########