; 190
##########
#.$    $.#
#        #
# $   @  #
#  ## # ##
# .     ##
# ########
#  $.#####
#     ####
##########