; 89
##########
##########
# ########
# #### @ #
#.#### $ #
#.#### $##
# ## #   #
#  $. $ ##
#  .     #
##########