; 865
##########
#   .  ###
#  $   ###
##### ####
##### ####
####   ###
#### $####
## $..  ##
#@$    . #
##########