; 9
##########
###      #
### $  . #
###  ##  #
###      #
###   @  #
###      #
###   $.$#
### $.##.#
##########