; 12
##########
####     #
#. # ### #
#$ #.### #
#   $  #$#
#      #.#
#   @  ###
#        #
#####  $.#
##########