; 188
##########
####     #
#####.$  #
######## #
##     . #
## # ##  #
#  @   $ #
#        #
#.$    $.#
##########