; 17
##########
#####  ###
#.$  @$. #
#      # #
#$#    # #
#.###### #
###      #
### ######
###   $.##
##########