; 555
##########
#### #####
#### #####
##   #####
#  #..####
#. $$ .$ #
#  #@    #
# $#######
#  #######
##########