; 460
##########
#@.   ####
#$ .######
#.$#######
#  $  ####
# $  #####
#   .#####
#### #  ##
##     ###
##########