; 18
##########
####.$ .##
###### $##
#.$ #   ##
### #   ##
### #  @ #
### #  $ #
### ###.##
###     ##
##########