; 780
##########
###      #
####$. $ #
#### ##  #
###  ##$ #
###  ## .#
####  ## #
###.$.   #
###  @#  #
##########