; 100
##########
####.$ $.#
#      $.#
# ###  $.#
#   # ####
### # ####
#   # ####
# ### @###
#     ####
##########