; 82
##########
#.$    $.#
#####    #
# $.#   ##
# ### @ ##
#  #     #
## #  $  #
## ###.###
##     ###
##########