; 367
##########
##@#######
##.  .   #
# $  $.$ #
#   ######
# ########
#      ###
# $     ##
# ###   .#
##########