; 66
##########
#    #####
# $. ##@##
#.   .#$##
# #      #
#  # .   #
#  # $ $ #
# ## #   #
# ########
##########