; 76
##########
#      ###
# ####.###
# #   $  #
# ### @  #
# $.#  # #
#####.#  #
#####$  $#
#####   .#
##########