; 30
##########
######.$ #
#   ##.$ #
# @      #
# $   ####
##.#######
##  $.####
##########
##########
##########