; 5
##########
#.$    #.#
#  #   #$#
#    $.# #
##   ### #
##@ $. # #
##   # # #
###### # #
######   #
##########