; 462
##########
###  #####
# # .#####
#.$   ####
#     # .#
# ## ### #
# ##     #
# #  $$$.#
##### @ ##
##########