; 55
##########
###.#    #
###$#    #
### #  #.#
### .$@#$#
#####  # #
######   #
######   #
###### $.#
##########