; 909
##########
#   # @###
#  $ . .##
# .$ $ ###
#  ##.  ##
######  ##
####   ###
# $    ###
#     ####
##########