; 60
##########
#  $.#####
#    .####
#  ##  ###
#    $ ###
#        #
#$  @ # $#
#. #####.#
##########
##########