; 21
##########
####.   ##
####$ $ ##
###.  .  #
###$ #   #
###    @ #
###  ##  #
### $##  #
###   .  #
##########