; 182
##########
#        #
# .  $ $.#
#######. #
#######  #
######## #
#   ####.#
# $@$    #
#  #     #
##########