; 131
##########
# ##     #
# ##$$#  #
#   @ .  #
#  ##.#. #
# $####  #
#  ##### #
# # ##   #
#  .   $ #
##########