; 54
##########
##########
##########
#.       #
#$  @ $  #
#   ## # #
#     . $#
##.$    .#
##########
##########