; 39
##########
##  ######
## $ #####
##.  #####
##  #.#@##
## .  $$ #
##  #  . #
### ###$ #
#####    #
##########