; 962
##########
##########
##########
# ########
# ########
#.#@ #####
#.$$  ####
# $.$ ####
#   .#####
##########