; 952
##########
###  #####
###     .#
####.  $ #
# .     ##
#  $ #$  #
#.####  ##
# #####$ #
# #####@##
##########