; 680
##########
##@  .   #
##  # ## #
#   ###  #
#   ###$ #
# .####  #
# $ $  $ #
#  .#  . #
##########
##########