; 42
##########
####.$ $.#
#####    #
#####    #
# $.#    #
# ### @  #
# ### $  #
# ####.###
#      ###
##########