; 156
##########
#.$      #
######## #
#   #    #
#$  #.####
#.   $   #
#        #
# $ #@#  #
# .      #
##########