; 37
##########
#     .###
# $#$  ###
#$ .  ####
# @  #####
#  $   ..#
#. $ ##  #
##  $    #
###     .#
##########