; 232
##########
##########
##########
##@   ####
## $$$.###
###    $ #
### #   .#
######   #
###   .. #
##########