; 25
##########
###  #   #
###  # # #
###  # # #
##@ $. #$#
##   ###.#
##   # ###
##      ##
##.$  $.##
##########