; 330
##########
#  ####. #
#     $$ #
#  $. #@ #
# .#######
#.# ######
# $ ######
#   ######
##########
##########