; 468
##########
##########
##########
#######@##
###### $ #
######$. #
######   #
##### $$.#
###  . . #
##########