; 144
##########
##  #  ###
# .  $  ##
#  ##    #
#$  @    #
#.   ### #
###  $.# #
####     #
###   $.##
##########