; 40
##########
##    . ##
##   #  .#
##   #  $#
##   #   #
#     $  #
#        #
#$  .$ ###
#. ### @##
##########