; 95
##########
#....##@##
#$$$$## ##
#    ## ##
##       #
## ##### #
## ##### #
##  #### #
##       #
##########