; 781
##########
##########
##########
##########
## #@#####
##  $#####
##$$  ####
# $.. ####
#. .  ####
##########