; 583
##########
###### . #
###### $@#
#######  #
#  ### $ #
#     $. #
#  #     #
# .####$ #
#  .     #
##########