; 40
##########
###      #
###.####$#
#  $ ###.#
#  @ #####
#    #####
#    #####
#    #####
#.$ $.####
##########