; 916
##########
##########
##.#######
#.    ####
#  $ #####
# # $@####
# .$ #####
# $. #####
#  #######
##########