; 45
##########
##########
##########
########.#
#.######$#
#$     # #
#    @$. #
#$     ###
#.     ###
##########