; 817
##########
##.      #
###### $ #
##### #  #
#  .  #  #
#  .#    #
# .####  #
# $  $@$ #
#     #  #
##########