; 859
##########
##########
##########
####### ##
# $   . ##
#  .$ $ ##
#.####   #
# @  ## ##
#.    $  #
##########