; 336
##########
##########
#####    #
##### $ $#
###.### @#
# $   # .#
# # .### #
# ## $ #.#
#        #
##########