; 49
##########
#  .  .###
# $  #####
#.$ ######
#  #######
# #  #####
#  $ ## ##
#.   @ $ #
#        #
##########