; 383
##########
# .. #####
#   ######
##  ### ##
# $  $   #
#  @   ..#
# # $ ####
# # $#####
#     ####
##########