; 144
##########
#  #######
# ########
# . ######
#  $######
#$$   $@##
#   .. ###
# ########
#.########
##########