; 16
##########
#      ###
#   @    #
#.##  .$ #
# ## #   #
# $    $.#
#    $.###
##########
##########
##########