; 409
##########
# $   . .#
#      # #
# ###### #
#  #.#   #
# $@$  $ #
#  # .   #
##########
##########
##########