; 939
##########
##########
##########
#######@##
#######$##
#        #
#  . $$. #
# . #. $ #
#######  #
##########