; 502
##########
##########
##########
##########
#### #####
#. ..$   #
#@$$ #   #
# .#$ ####
#      ###
##########