; 989
##########
######   #
##### #  #
#     $  #
#.$# @.  #
#   ### .#
#     #  #
#   $$ # #
###.     #
##########