; 30
##########
##########
####@   .#
#       $#
#   $    #
####.##  #
#    #  $#
# ##### .#
#   $.####
##########