; 700
##########
#. .   ###
#    .####
#  #######
#.  ### ##
##  $    #
##   $ $ #
##     $ #
##### @ ##
##########