; 694
##########
#.       #
## $  $. #
##  ###  #
###     .#
### $# # #
###$ #####
### ######
##@.######
##########