; 356
##########
##########
##########
##########
##########
#######  #
### # ...#
### $ $ $#
##@$ .   #
##########