; 0
##########
#        #
# ###### #
#    #.#$#
####.#$#.#
### $  ###
### @    #
###     $#
######  .#
##########