; 13
##########
#   #  ..#
# # #  $$#
# #      #
# ###    #
#   #  $.#
### #  $.#
#@# # ####
#     ####
##########