; 155
##########
#      #.#
# ###  #$#
# #@   # #
# ## ### #
#  #     #
## #### $#
##      .#
####.$ $.#
##########