; 313
##########
#       ##
#.$ $@####
#. #######
# $ ######
#  #######
#.  ######
#.$#######
#  #######
##########