; 201
##########
#   ######
# .$######
#. $@#####
#   ######
# #  #####
#  . #####
# $$######
#.  ######
##########