; 992
##########
#@  ######
# $$######
#   ######
#.$.######
#. #######
# $ ######
# . ######
#  #######
##########