; 254
##########
# ..     #
# $    $ #
### #### #
## $ ##  #
##  .  . #
####  #$ #
#######  #
########@#
##########