; 112
##########
##########
##########
##########
##########
# $.   ###
#..$  .###
# $$######
#  @######
##########