; 221
##########
#     $.##
# #.$    #
#    #####
#    # $.#
#    # ###
# #  # ###
# @ $. ###
#    #####
##########