; 19
##########
#    .####
#    ## .#
#  ###   #
#      $ #
#  @ $  $#
# $      #
# .### . #
##########
##########