; 104
##########
#.$ ######
#.$      #
#.$  ##  #
#.$  #   #
#### #@# #
#    ### #
# ###### #
#        #
##########