; 238
##########
#    .####
# @  $####
#      ###
# $      #
##.####  #
##    # $#
#####$# .#
#####.# ##
##########