; 179
##########
##      ##
#. .  $ ##
#$  ##   #
#    #   #
#    #  $#
#$  @#  .#
#.      ##
###     ##
##########