; 3
##########
###### $.#
######   #
###.$    #
#####   ##
### .$@ ##
### #   ##
###$######
###.######
##########