; 510
##########
##### $. #
##### @$ #
#### .## #
#####  $ #
#####. $ #
#####  # #
##### .# #
#####    #
##########