; 40
##########
###  $.###
###.######
#  $ #####
#  @ #####
#    #####
#    #####
#    #####
#.$ $.####
##########