; 120
##########
##     ###
##     ###
##  @#.###
##   # ###
#     $ .#
#$#     $#
#.  .$   #
##########
##########