; 2
##########
#  @ $ .##
# $     ##
#  ##    #
## ###   #
#   .   $#
# ###    #
#  ###  .#
# $ .####
##########