; 581
##########
#     #. #
# # .$$  #
#  #  @$ #
# #### . #
# ########
# ########
#     ####
# $  .####
##########