; 173
##########
#   ### .#
#$    # $#
#.  $    #
##  ##.  #
##@ ###  #
##  ##   #
##$      #
##.     ##
##########