; 793
##########
##########
##########
##########
##########
#.   ##  #
#.$$#  $ #
# .$   . #
# @      #
##########