; 423
##########
##########
##########
####### ##
#####    #
##@$     #
##$$ #   #
# $ . #  #
# . . .  #
##########