; 750
##########
# .#######
# $#######
#  #######
# .#######
#        #
#.$## $. #
#  ### $ #
# ## @   #
##########