; 195
##########
###    .##
###    $ #
# .$ @#  #
# #      #
# #  # # #
# ###### #
# ####.$ #
#  $.#   #
##########