; 75
##########
#     ####
# ###$####
# # #.####
# # ######
# #   .$ #
# .$@ #  #
###  #   #
###    $.#
##########