; 15
##########
##########
##########
#.##   ###
#$##   ###
#  .$@ ###
####    ##
##.$    ##
##.$    ##
##########