; 10
##########
##########
#   ####.#
#      #$#
#   @  # #
#   $  # #
#$$#.### #
#..# ### #
####     #
##########