; 185
##########
##   #####
# $ ######
#  $@#####
#  $ #####
##.$######
##  .#####
##  # ## #
#.  .    #
##########