; 676
##########
###    . #
##  # .  #
###.$ #  #
###  $#  #
### #@.$ #
#######$ #
#######  #
##########
##########