; 146
##########
#.    $. #
#$ # ### #
#  #     #
### # @  #
#.#      #
#$#   $  #
# ####.###
#      ###
##########