; 655
##########
#       .#
#  @#  . #
#  ####  #
# $#### ##
#  ####  #
# #####  #
# $.. $$##
# #     ##
##########