; 22
##########
##########
####### .#
#######$ #
#######  #
##### # .#
#@$  .$$.#
##       #
######## #
##########