; 111
##########
#....#   #
#$$$$# # #
#    # # #
##     # #
## ##### #
## # @## #
##   ### #
##       #
##########