; 628
##########
#####    #
##### .###
### # $###
#  ..$ ###
# $ #   ##
# #  #   #
# # #  $@#
###     .#
##########