; 76
##########
#      ###
#$####.###
#.#   $  #
##### @  #
#####  # #
#####.#  #
#####$  $#
#####   .#
##########