; 50
##########
##########
##########
#       .#
#  $ @  $#
# # ##   #
#$ .     #
#.    $.##
##########
##########