; 907
##########
###  . $@#
## $   $ #
##..######
##   #####
## $ #####
##. ######
###  #####
### ######
##########