; 180
##########
#      ..#
# #### $$#
# #@##   #
# #    $$#
# # ###..#
# #   ####
# ###  ###
#        #
##########