; 78
##########
#@     $.#
# #      #
# #  #.$ #
#        #
#  $     #
#   ###  #
## .     #
###    $.#
##########