; 69
##########
#.$    ###
#      ###
#$  @ $. #
#.     # #
#####  # #
#.$ #### #
### ##   #
###    ###
##########