; 15
##########
##########
##########
##########
#  #######
# $ ######
#. ##  ###
# .  $ $ #
# .  . $@#
##########