; 288
##########
######## #
#######. #
#  ###.  #
# $@##$$ #
#  ##    #
# ###  # #
#. ## $. #
#        #
##########