; 370
##########
#        #
##  .    #
## #     #
## ##. ###
## $@$####
## $. ####
##. $#####
###  #####
##########