; 25
##########
###### @ #
######.$$#
####### .#
#######$ #
#######  #
#######$ #
####  # .#
####    .#
##########