; 483
##########
## . $  ##
##  . $@##
## $#### #
##  #### #
###  ###.#
### ###  #
###.### $#
##       #
##########