; 58
##########
# $.## $.#
#        #
##   @   #
###  $   #
#.###.####
#$###    #
# ###### #
#        #
##########