; 56
##########
#        #
# ###### #
#    ###$#
####.###.#
#   $  ###
#   @   ##
#        #
#.$ ##.$ #
##########