; 157
##########
###@$.   #
#### $   #
########.#
#####    #
##### $. #
#######$ #
#######  #
####### .#
##########