; 55
##########
#   #    #
# # #    #
# # #  #.#
# # .$@#$#
# ###  # #
#    #   #
####$#   #
####.# $.#
##########