; 68
##########
#      ###
# ####.###
# #   $ ##
# #   @  #
# #    # #
# #.$  # #
# ####   #
#  $.# $.#
##########