; 164
##########
####  $.##
##  .   ##
## $##  ##
#@  ##  ##
#   ##   #
#        #
#      $.#
#####  $.#
##########