; 3
##########
#.$ .#####
#.$ $#####
#      ###
##     ###
##    @###
##  #  ###
## . $ ###
##     ###
##########