; 54
##########
#.###   ##
#$# .$@ ##
# # #   ##
# # #  ###
# # #  ###
# # ## ..#
# # ## $$#
#   ##   #
##########

