; 466
##########
######  ##
###### $@#
######. ##
# ####$ ##
#  ###   #
# $###$ ##
# .# #  ##
#..      #
##########