; 749
##########
#.      ##
# $ $ .###
#  ##   ##
# .###  ##
# $###. ##
#$ ##  ###
#@#### ###
##########
##########