; 39
##########
###      #
#   #### #
# ####.#$#
# #   $#.#
# #    ###
# .$@   ##
###      #
###    $.#
##########