; 397
##########
#  ..  . #
#.   $ $ #
#  ### $##
# ####   #
# #### $ #
#######@##
##########
##########
##########