; 922
##########
#     ####
#   ######
# $#######
#  #######
# ########
# .$ #####
#.$ .$@###
#    .####
##########