; 101
##########
#### ##@##
#     .$ #
#.$  ##  #
#  ####. #
#$# ###  #
#.    #  #
# $ ## # #
##       #
##########