; 34
##########
#. ##.$  #
#$  #### #
#    $.# #
#     ## #
#  @  ## #
#  $  #  #
###.### ##
###     ##
##########