; 26
##########
##   #####
## # ###@#
## #     #
## ##### #
#  #.$ # #
# #      #
#   $$$###
####...###
##########