; 799
##########
#  #######
#. ##.## #
#  . $@$ #
# $ $ #  #
#  ##### #
# #####  #
#. ##### #
#        #
##########