; 103
##########
# .#######
# $ $ ####
#@$   ####
#.  # ####
#.###.## #
#        #
#   # #$ #
# #####  #
##########