; 419
##########
#   ######
# $ . ####
# $ ######
##$ ######
##  ######
## ### ###
# $  # ###
# .. .  @#
##########