; 56
##########
#.$      #
#   $.$$ #
## ###.. #
##   ### #
####   # #
#### # # #
#### # # #
####@#   #
##########