; 685
##########
##########
##########
#@## ### #
# #      #
#   $.#  #
# $# .$$.#
#  ####  #
# #####. #
##########