; 187
##########
##########
## #######
#  #######
#  #######
#.########
# ##### .#
#$$  $ $@#
# . .    #
##########