; 61
##########
#  #######
#$  ####.#
#.   ###$#
##   ### #
## @$. # #
#    # # #
#$   # # #
#.   #   #
##########