; 87
##########
# ##    .#
# #    @$#
#    $   #
#  .#   $#
#  ### #.#
#  ##    #
#        #
#      $.#
##########