; 427
##########
##########
##########
##### ####
# $.  # ##
#@$ $ #.##
# ##. #  #
# ###.$  #
#        #
##########