; 71
##########
####    .#
###  ## $#
# .$@    #
# #    ###
# #   $#.#
# #   .#$#
# ###### #
#        #
##########