; 1
##########
###     ##
### $ . ##
###  #  ##
###@    ##
###     ##
###      #
#####$ $.#
#####. $.#
##########