; 2
##########
#.  ######
#$     ###
#    @ ###
###  $ ###
###$#.####
###.#  $.#
##########
##########
##########