; 161
##########
#   .  ###
#   $ ####
##.#    ##
# $##   ##
#.@ ## ###
# $### ###
#$ #   ###
#  .  ####
##########