; 181
##########
#        #
# ###### #
# #   @# #
# # # ## #
#   # ## #
#  ##    #
# ##.$ $.#
# ##.$ $.#
##########