; 71
##########
####    .#
###  ## $#
# .$@    #
# #    ###
#$#   $###
#.#   .###
##########
##########
##########