; 565
##########
#       .#
# $   @# #
###$ ##. #
###  ## $#
###.  #  #
### $.   #
####  #  #
#######  #
##########