; 721
##########
########.#
####### @#
#######  #
######## #
#######. #
##### $$ #
#### $ $ #
#### ..  #
##########