; 192
##########
#   #    #
# #   ## #
# ###### #
#        #
# ###.$ $#
#@###.$ .#
#####.$ ##
##########
##########