; 550
##########
##########
##########
##### ####
####   . #
### . #$ #
###$ ##  #
# .   $ @#
# $  . # #
##########