; 435
##########
#######  #
#######. #
### $.$$ #
##     $ #
##. #### #
##@ .##  #
##       #
##       #
##########