; 119
##########
#####.$ ##
#####   ##
###.  $.##
### #  ###
## @#  ###
##  #  ###
## $  $###
##    .###
##########