; 128
##########
##      ##
#    $  ##
#  ##  ###
#$   . ###
#.       #
## @## $.#
##     $.#
####  ####
##########