; 27
##########
#   ##   #
# # ## $$#
# # ## ..#
# # #  ###
# # #  ###
# # #   ##
#$# .$@ ##
#.###   ##
##########