; 35
##########
###    $.#
###      #
# .$@   ##
# #    ###
# #   $###
# ####.###
#   ######
###   $.##
##########