; 768
##########
##########
##########
####### ##
####  @  #
####   $ #
####$### #
## $.   .#
#  . .$  #
##########