; 357
##########
###    . #
###### $.#
###### . #
###### . #
###### $ #
######  $#
###### $ #
###### @ #
##########