; 596
##########
# .#######
#$.#######
#   ######
#.  ######
#$$ ######
#  #######
#@$#######
#.  ######
##########