; 398
##########
##########
### #@####
#    $   #
#  $     #
#  ####  #
# ##### .#
#    ##$ #
#.  . $ .#
##########