; 152
##########
###      #
### .    #
##   ##$ #
##   ##  #
#    # @ #
#.$      #
#.$  ##  #
######.$ #
##########