; 124
##########
###     ##
###     ##
###.#@  ##
### #   ##
#. $     #
#$     #$#
#   $.  .#
##########
##########