; 492
##########
###   ####
###.  ####
### $#####
###  #####
#### $  ##
###   @. #
###   $$ #
### ..   #
##########