; 78
##########
#.   #####
#$  $#####
#  #.#####
# #  #.$ #
#  @ ### #
#  $   # #
###.#### #
###      #
##########