; 56
##########
##########
##########
#.$  #####
####.#####
#   $  ###
#   @   ##
#        #
#.$ ##.$ #
##########