; 277
##########
##########
# @#######
##$#######
#   ######
# .$#### #
# $ #### #
# .. #   #
#.     $ #
##########