; 24
##########
###...####
###$$$   #
#      # #
# # $.#  #
# ##### ##
#     # ##
#@### # ##
#####   ##
##########