; 675
##########
# .## # @#
#   $. $ #
# $.   $ #
#   ### ##
#  #######
# .#######
# ########
# ########
##########