; 209
##########
#       .#
##   # $ #
#######  #
####### .#
### $    #
### $$ ..#
###    @ #
######## #
##########