; 92
##########
#       ##
#       ##
#  # #   #
# @#  $ $#
#   .#  .#
#$  ##  ##
#.  .$ ###
##########
##########