; 661
##########
# ..   $@#
#.  $ $ ##
# ##  ####
# ########
#  ###   #
#      $ #
#   .    #
#####    #
##########