; 117
##########
###.    ##
###$  $ ##
###  #  ##
###  #@ ##
###  # ###
##.$  .###
##   #####
## $.#####
##########