; 7
##########
#   ######
# # ######
# # #   ##
# # .$@ ##
# ###   ##
# #.$    #
# ####   #
#  $.# $.#
##########