; 340
##########
#    #####
#  .######
#.$#######
#  #######
# $#######
#  #######
#@$      #
# . #. $ #
##########