; 94
##########
#  $.#.$ #
# ####   #
# #  @   #
# #    # #
# #  $   #
# ###.#  #
# ### # $#
#     ##.#
##########