; 829
##########
#  ##    #
# ###  $ #
#  ###@# #
#.#### # #
# .    $ #
# .$ . # #
# $ ######
#  #######
##########