; 615
##########
#  .$ . ##
##. .@   #
## $$ $ ##
#   ######
#  #######
## #######
##########
##########
##########