; 163
##########
#   #    #
# # # ## #
# #   ## #
# @##### #
# ##  ## #
# #.$ $. #
#        #
###.$ $.##
##########