; 283
##########
##########
##########
##########
####   ###
###  $.###
###$ . ###
##.$   ###
#   .  $@#
##########