; 361
##########
#@$   .  #
#   ## $ #
# .####. #
# $####  #
#  ####$ #
# ##### .#
# ########
# ########
##########