; 23
##########
###  #####
# .$@  $.#
# #      #
# #    #$#
# ######.#
#  $.#####
##########
##########
##########