; 645
##########
##########
##########
##########
####### ##
#######  #
##### .$ #
## $@.$$ #
#    . . #
##########