; 37
##########
#   ######
# $# ##  #
#.$  . $ #
#.     $ #
#  ### #@#
# .#######
# ########
# ########
##########