; 121
##########
#      ###
#$     ###
#.# @ $. #
### #  # #
###    # #
##.    # #
##$ #### #
##  #.$  #
##########