; 124
##########
#      ###
# $$.$   #
# ..#### #
# $.#    #
# #### #@#
#    # ###
#  # # ###
##     ###
##########