; 150
##########
###   $.##
####     #
###  $.# #
#.   ### #
#$  @    #
#  ##    #
# .  $  ##
##  #  ###
##########