; 52
##########
#   .   ##
#. #$ # ##
#  # ##  #
#$$ .## ##
#@$. #  ##
######  ##
##########
##########
##########