; 122
##########
###  #####
###@$.####
####$#####
# #. #####
# #  #####
#    #####
# .$ $. ##
#  #   ###
##########