; 960
##########
# .  #####
# .$@#####
# $ ######
## #######
#  #######
##  # ####
#  $ $   #
# .  .   #
##########