; 703
##########
#  .     #
#   $...##
#  # ##  #
# ##  #  #
# #  ## ##
#    #####
# $$$#####
### @#####
##########