; 50
##########
#.   $.  #
#$  ###  #
#    @   #
#### $   #
#####.####
#####  $.#
##########
##########
##########