; 772
##########
#     ####
# $.$@####
#   ######
#..#######
# $#######
# .#######
# $ ######
#   ######
##########