; 0
##########
# $.######
# ########
#    #.###
####.#$###
### $  ###
### @    #
###     $#
######  .#
##########