; 92
##########
###### $.#
#      $.#
#  ##  $.#
# ###  $.#
# ### ####
# ### ####
# ###   @#
#     ####
##########