; 46
##########
#.$ $.####
#    #####
#    #####
#    #####
#  @ #####
#  $ #####
###.######
###  $.###
##########