; 392
##########
#  #######
# $ . ####
# $ ######
#. #######
#  #######
#.$    ###
#$  . ####
#@########
##########