; 11
##########
#..  #   #
#$$  # # #
#      # #
#    ### #
#.$  #   #
#.$  # ###
#### # #@#
####     #
##########