; 175
##########
####    .#
###  ## $#
# .$ @#  #
# #   #  #
# #   # $#
# #     .#
# ########
#      $.#
##########