; 199
##########
#  #     #
# $# @   #
# .# # # #
#      # #
# ##$  # #
# ##.  # #
#     $# #
# $.#   .#
##########