; 114
##########
#.   #####
#$   @####
# #      #
#    $   #
#$ ##.####
#. ##    #
######## #
#.$      #
##########