; 70
##########
#.$ ######
#   ######
# #  $.###
# #    ###
#  @   ###
## $   #.#
###.####$#
###      #
##########