; 38
##########
#  $.## .#
# ####  $#
# #.$    #
# ##     #
# ##  @  #
#  #  $  #
## ###.###
##     ###
##########