; 60
##########
#        #
# ###### #
#$###    #
#.###.####
###  $   #
##   @   #
#        #
# $.## $.#
##########