; 178
##########
#   #   .#
# #$#$  $#
# #.#.#  #
# ### @# #
# #      #
# #   $  #
# ####.# #
#      ###
##########