; 677
##########
#    ..  #
# $#.  ###
#  # $####
# ##@ ####
# ## $ ###
# ##  ####
# ##.$####
#  #    ##
##########