; 59
##########
#   $.# .#
# ##### $#
# #      #
# #  # ###
# #      #
# .$ @#  #
###     $#
####### .#
##########