; 347
##########
##.#######
# $ ######
#$@.######
#.$#######
#  #######
# $#######
#  #######
#. #######
##########