; 77
##########
##########
##########
###### #.#
###### #$#
# $.   # #
#  # @$. #
#   #  ###
#.$    ###
##########