; 31
##########
#####   ##
### .$@ ##
### #   ##
### #  ###
### #  ###
### ## ..#
#.$ ## $$#
######   #
##########