; 160
##########
##.$  ####
##   .  ##
##  ##$ ##
##  ##  @#
#   ##   #
#        #
#.$      #
#.$  #####
##########