; 742
##########
###### . #
#### ##  #
#### #  ##
###      #
###.$.#  #
###.$ ## #
####$$ # #
##     @ #
##########