; 754
##########
##@      #
##.  #   #
## $ ### #
###  ### #
## $ ##  #
##. ###. #
# $ ###$ #
#     .  #
##########