; 70
##########
#######  #
####### $#
#######  #
# ##@##  #
#   $ #  #
# #. .#  #
##. $$# .#
#        #
##########