; 179
##########
##########
##########
##### ####
##  .    #
# $.   .$#
# ###  $ #
# #####$.#
#     @  #
##########