; 954
##########
#######  #
#######$.#
### ##.  #
# $     @#
#   #. $##
# ####   #
#  ####  #
# $  .  ##
##########