; 87
##########
# ########
# .#######
#  #######
#.  ######
# $$######
#.   #####
# $$.#####
##@ ######
##########