; 657
##########
##########
#####@ ###
#####$$###
#####   ##
##### .###
##### $ ##
# # $..###
#.     ###
##########