; 586
##########
###   ####
# $ $    #
# $#   . #
#  #. #  #
#  ####  #
# #####. #
# ##  .$ #
# @      #
##########