; 99
##########
#   .  $@#
# .$$ $ .#
###  #####
### .#####
#### #####
##########
##########
##########
##########