; 643
##########
###   .. #
### .. $ #
#####$$$ #
#####@ # #
##########
##########
##########
##########
##########