; 79
##########
###    $.#
###  #   #
# .$@ #  #
# #   .$ #
# # ######
# # ######
# ########
# $.######
##########