; 529
##########
##@$  .  #
## $.  . #
#### $ $ #
#######. #
#######  #
##########
##########
##########
##########