; 91
##########
#     $.##
#   @   ##
#  ##   ##
#    .#.##
#  # ##$##
#   $   ##
#      ###
### $.####
##########