; 63
##########
##    ## #
##..#### #
##   ##  #
##  # #  #
##.$   $ #
##   $   #
#######$ #
### . @  #
##########