; 89
##########
#        #
# ###### #
#$#   ## #
#.#   ## #
###@ $.  #
#.    ####
#$  #   ##
#      $.#
##########