; 30
##########
######.$ #
#   ##.$ #
# @      #
# $   ####
##.#######
##       #
######## #
#####.$  #
##########