; 508
##########
#######  #
# $ $  $ #
#  .  .. #
# #####. #
#####  $ #
######   #
### #### #
###@     #
##########