; 879
##########
######## #
# #####  #
# .#### @#
# $##### #
#      $ #
#  .#. # #
# .$$ ####
#     ####
##########