; 875
##########
##########
##########
#######  #
#  ####. #
# $ ###  #
#  $    @#
# $. #.$.#
#   #    #
##########