; 593
##########
##@#######
#.$#######
#   ######
# .$######
# $ ######
#   ######
#$..######
#   ######
##########