; 227
##########
##########
#####.####
#####   .#
#####   ##
## $     #
##. $ $  #
#  $######
# .@######
##########