; 34
##########
###@######
### ######
#    #...#
# # #.$$$#
# # #$   #
# #      #
# #### ###
#      ###
##########