; 138
##########
# $.     #
#    .$  #
##### ## #
# $.# @  #
# ##    ##
# #   $ ##
# ####.###
#      ###
##########