; 77
##########
######.$ #
######## #
###### # #
###### # #
# $.   # #
#  # @$. #
#   #  ###
#.$    ###
##########