; 19
##########
######.###
######$###
#      ###
# ######.#
# #    #$#
# #      #
# .$@  $.#
###  #####
##########