; 159
##########
#     ####
##.  $ ###
# .# $@###
# $#  ####
#  #######
#   ##   #
#  ### $ #
#..      #
##########