; 778
##########
# ########
#  #######
# $ #### #
#  $ .$  #
# . .  .@#
# #$ ### #
##   ##  #
#######  #
##########