; 48
##########
## $  .###
##   $  .#
##     @ #
#    $  ##
#   ######
#     .###
#       ##
##.   $ ##
##########