; 34
##########
#. #######
#$  ######
#    $.###
#     ####
#  @  #.##
#  $  #$##
###.### ##
###     ##
##########