; 938
##########
##########
##########
####@### #
####.  $ #
###  $ $ #
##  ..#  #
###. ##$ #
####     #
##########