; 4
##########
##.$     #
######## #
###.#    #
###$#.####
###  $ ###
#    @ ###
#$     ###
#.  ######
##########