; 872
##########
##########
##########
# ########
#  # @  ##
# ###$$###
#.###  ###
#$$  . ###
# .   . ##
##########