; 153
##########
##.. #####
##$$   ###
##       #
##     . #
### ###  #
#.#  ##  #
#$  @ $  #
#        #
##########