; 67
##########
#     $.##
# ########
# #   .###
# #   $###
# #    ###
# .$@    #
###  ## $#
####    .#
##########