; 211
##########
###      #
###. $   #
## $ ##$ #
#  .###@##
# #.######
#  $ #####
# .  #####
#    #####
##########