; 934
##########
###### ###
###    . #
### $@$ .#
#######$ #
#######  #
####### .#
#######.$#
######   #
##########