; 34
##########
#. #######
#$  ####.#
#    $.#$#
#     ## #
#  @  ## #
#  $  #  #
###.### ##
###     ##
##########