; 947
##########
#####@$. #
######.$ #
## ###   #
#     # $#
# $ ### .#
#  ##### #
#  ####  #
#       .#
##########