; 132
##########
#      $.#
# $$$    #
# ...### #
# ####   #
# #### # #
#  ### #@#
## ### ###
##     ###
##########