; 521
##########
##########
#####  ###
##### $. #
#####.   #
###### #.#
##### $$ #
##### $  #
####  .@ #
##########