; 36
##########
#      ###
# #### ###
# #      #
# # #$   #
# # #.$$$#
#    #...#
### ######
###@######
##########