; 203
##########
##########
##  @ ####
##.$ #####
### ##  ##
###  # . #
##  $#   #
## $   $.#
## . #   #
##########