; 19
##########
##.$   ###
###### ###
#      ###
# ######.#
# #    #$#
# #      #
# .$@  $.#
###  #####
##########