; 6
##########
######  .#
###     $#
### @    #
### $  ###
####.#$#.#
#    #.#$#
# ###### #
#        #
##########