; 14
##########
##########
###      #
# $      #
#   ####.#
#$  ####.#
#.  @### #
#     $  #
#.  $    #
##########