; 13
##########
##    $.##
##    $.##
##    ####
### @$.  #
###   ##$#
###   ##.#
##########
##########
##########