; 123
##########
#####.$ ##
#####   ##
#  . $  ##
#  ##  $##
#  @   .##
#       ##
#     # ##
##### $.##
##########