; 14
##########
##########
#.####   #
#$#      #
# #  @   #
# #  $   #
# ###.#$$#
# ### #..#
#     ####
##########