; 48
##########
# $.######
# ########
#    #####
####.#####
#   $ ####
#   @    #
#  ###  $#
#  .$   .#
##########