; 929
##########
# .   .. #
# $ # $@ #
#   ###$##
#   ##   #
# $###  .#
#  ####  #
##########
##########
##########