; 183
##########
#.$ $.## #
#.$ $.## #
#    ##  #
# ## #   #
# ## # # #
# #@   # #
# ###### #
#        #
##########