; 304
##########
##########
##########
##########
##########
#####@####
##. $$.###
#.$$.   ##
#       ##
##########