; 385
##########
##########
##########
######  ##
##### $ ##
# ### $ ##
#. ## $@##
#   $  ###
# .  ..###
##########