; 594
##########
####### ##
###### .##
####@$   #
##. $$.$ #
###  .  ##
##########
##########
##########
##########