; 223
##########
#####    #
### .$ @ #
### #  # #
### #    #
#.$ #    #
#####    #
#    $.# #
##.$     #
##########