; 199
##########
#     @###
# ## #####
#  # #####
## # #####
#  # ...##
# ## $$$##
# ##    ##
#    $.###
##########