; 204
##########
#      ###
# $#  . ##
#  ### $ #
#  ## $$ #
#  ##. @ #
#  ###.###
# .#######
##########
##########