; 48
##########
##########
##########
#.$  #####
####.#####
#   $ ####
#   @    #
#  ###  $#
#  .$   .#
##########