; 649
##########
#@ #######
#$ #######
# ########
#  #######
# $#######
# $.  ####
# $  .####
#. .######
##########