; 172
##########
#      ###
# ####.###
# #   $ ##
# #      #
# #   @# #
# # #### #
#$#      #
#.#.$  $.#
##########