; 17
##########
#####  ###
#.$  @$. #
#      # #
#$#    #$#
#.######.#
##########
##########
##########
##########