; 38
##########
######@###
###### ###
#...#    #
#$$$.# # #
#   $# # #
#      # #
### #### #
###      #
##########