; 1
##########
######   #
###### #$#
##   # #.#
## @$. ###
##   #####
#    $.###
#   ######
#.$ ######
##########