; 139
##########
####### ##
####     #
##### .$ #
####@$.# #
#####  # #
# ..  ## #
#  # $$  #
#        #
##########