; 854
##########
#      ###
# $ #.  ##
# ###  ###
#  ##   ##
#.$$ $ ###
# .##. ###
#  #######
#@########
##########