; 140
##########
##########
#       ##
# #@### ##
# ##     #
# #  .$  #
# # #.$  #
# # #.$  #
#   #.$  #
##########