; 182
##########
#.   #   #
#$  $#$# #
#  #.#.# #
# #@ ### #
#      # #
#  $   # #
# #.#### #
###      #
##########