; 42
##########
#.  $ ####
#.      ##
#       ##
##$  ##.##
##   $  ##
#       ##
# @#$   ##
#.     ###
##########