; 531
##########
#      . #
# $$.@ $.#
#  ####$ #
# #####  #
# ########
# ########
#  ## ####
#.      ##
##########