; 393
##########
##    ####
###.$  ###
###   ####
####$. ###
#### . $@#
##### $ ##
######  ##
###.    ##
##########