; 819
##########
#### ##  #
####  #  #
###.$ ## #
###   #  #
###$ ### #
### $### #
###. ##  #
#@$..    #
##########