; 69
##########
##########
##########
####   ###
# $ $ .  #
# $  .  ##
#.########
# $ .#####
#@   #####
##########