; 944
##########
# .     .#
#   $ #  #
# $#####.#
#   ###  #
####   $@#
####  .$ #
###### ###
##########
##########