; 935
##########
#     . ##
# .$# $$##
#  $ ##  #
#   .   .#
# ##   ###
#@########
##########
##########
##########