; 255
##########
###      #
####@$$###
# ###$. ##
#  .#   ##
#      ###
#    $ ###
#..#######
##########
##########