; 115
##########
##########
##########
####.  ###
#### $# ##
####  .$ #
####  $  #
#####$   #
#### @.. #
##########