; 112
##########
##########
#####    #
###. @ $ #
### ###  #
#.       #
#$ $   $.#
#  .######
##########
##########