; 12
##########
#.$      #
##.    . #
##$ @ #  #
#.    #  #
#$     $ #
#        #
##########
##########
##########