; 33
##########
#####   .#
###  $   #
##  $    #
##.  #   #
## $ . $ #
##      ##
###    ###
##### .###
##########