; 417
##########
#  #######
# .##### #
#       .#
# $   .  #
# $  #####
## $ #####
#   $@####
#  . #####
##########