; 53
##########
##########
##########
#######  #
######## #
#   ###.@#
#   $ $$ #
#. #.$   #
#     . ##
##########