; 170
##########
#.#.$  $.#
#$#      #
# # #### #
# #   @# #
# #      #
# #   $ ##
# ####.###
#      ###
##########