; 29
##########
#.  ### .#
##$ ##   #
##  $    #
# @$     #
#  ###   #
# $###.  #
#    #####
#       .#
##########