; 37
##########
#.$    ###
#      ###
##   @$. #
###    # #
###$   #$#
###.####.#
##########
##########
##########