; 12
##########
#.$  ..###
#.$  $$###
#      ###
#        #
### #### #
#   #    #
# ### ## #
#     #@ #
##########