; 513
##########
# ###### #
#  ####  #
# $.. $..#
#@  $    #
# #####$ #
# #####  #
# ########
# ########
##########