; 136
##########
#.   #####
# $$ #####
#..#######
#  .  ####
# $  #####
#  #######
#$########
#@########
##########