; 216
##########
####@$ . #
####.$   #
#######$ #
#######  #
#######$.#
#######  #
########.#
#######  #
##########