; 631
##########
###    @ #
###$$. # #
##   $ ###
##. ######
##  ######
## $######
##.  #####
##.  #####
##########