; 50
##########
#.   $.  #
#$  ###  #
#    @   #
#### $   #
#####.####
#####    #
######## #
##.$     #
##########