; 196
##########
###      #
###.#### #
#  $  ##$#
#     ##.#
#  @ #####
#  #  #. #
#.$  ##$ #
##       #
##########