; 36
##########
#      $.#
# ########
# #     ##
#   ###.##
####   $ #
#        #
# $.## @ #
# $.######
##########