; 135
##########
########.#
###    #$#
# .$ @ # #
# #      #
# #  #   #
# #      #
# #####$ #
#   $.#. #
##########