; 63
##########
#   #   .#
#$# #   $#
#.# #    #
### .$@ ##
#####   ##
#####   .#
######  $#
#######  #
##########