; 47
##########
#####  $.#
#        #
#       ##
#      .##
# ###  $##
#.   $   #
#      #@#
##.$   ###
##########