; 39
##########
##########
#  $.#####
# ####.###
# #   $###
# #    ###
# .$@   ##
###      #
###    $.#
##########