; 235
##########
##.$  ####
#     ####
#####  ###
#.$ #  $.#
### #    #
### #    #
### .$ @ #
#####    #
##########