; 17
##########
#@     $.#
### ## $.#
### #  $.#
### #  $.#
### ##   #
###  ## ##
####  # ##
#####   ##
##########