; 109
##########
####     #
###    $ #
###  ##  #
###   #. #
####    ##
#.$ @   ##
#       ##
##.$ $.###
##########