; 285
##########
##########
##########
#  #######
# $#######
# @##  ###
#. ## $# #
# $.# .  #
# $   .  #
##########