; 453
##########
### .    #
###  $@$.#
###  #   #
###   #$ #
# ##  #  #
#. #  ## #
#$ # #####
#   .#####
##########