; 0
##########
##########
##########
#.$  #.###
####.#$###
### $  ###
### @    #
###     $#
######  .#
##########