; 696
##########
##########
##@#######
##$      #
##  .$ $ #
# .# $ # #
# .  ### #
#.  ######
#   ######
##########