; 831
##########
#.     . #
#.  # .$ #
#  ####$ #
##  ###  #
#  ##### #
#  $ ### #
##$  ### #
##@# #####
##########