; 45
##########
###      #
### #### #
###  $.# #
#.###### #
#$     # #
#    @$. #
#$     ###
#.     ###
##########