; 549
##########
# @   .  #
## $ $  .#
###$######
##  ######
### ######
##    ####
## . #####
#  $ . ###
##########