; 3
##########
#.#    $.#
#$#   #  #
# #.$    #
# ###   ##
# # .$ @##
# # #   ##
# # ######
#   ######
##########