; 48
##########
#..   ####
#$$ #   ##
#   ###  #
#$$    # #
#..### # #
######   #
######@###
##########
##########