; 730
##########
##  ######
##@      #
###  $  $#
####### .#
######   #
###  .$#.#
# ###  $ #
#    .   #
##########