; 180
##########
##  .$  .#
#  @.### #
#  ##### #
#  ####  #
#  ####  #
#   ###  #
#.$$ # #$#
#        #
##########