; 235
##########
#    #####
#@      ##
#    #$$ #
###  # $.#
###  # .##
#### $.  #
#### ## ##
####   .##
##########