; 24
##########
#   $.####
# ##### .#
#    #  $#
####.##  #
#   $    #
#       $#
####@   .#
##########
##########