; 735
##########
####   . #
###    $ #
###.#$ ###
## .#  ###
##     ###
###.  ####
####$$####
####  @  #
##########