; 107
##########
#     ####
# $    ###
#  ##  ###
# .#   ###
##    ####
##   @ $.#
##       #
###.$ $.##
##########