; 689
##########
##########
# ########
#.##### ##
#     $  #
# $. $@$ #
#. ##### #
#.# # ## #
#        #
##########