; 68
##########
###.$  ###
######.###
###   $ ##
###   @  #
###    # #
###.$  # #
######   #
###### $.#
##########