; 22
##########
#@########
# ########
#      ###
# ####  ##
# #  ##  #
#     ## #
#$$$$    #
#.... ####
##########