; 34
##########
### . ####
### $ ####
###   ####
# $  #####
#  .$ ####
# $#@#####
#  ##  # #
#   ..   #
##########