; 242
##########
###### . #
#### #   #
#        #
# $# . . #
#  ###   #
# .#### ##
# $$  $@##
#     # ##
##########