; 47
##########
#   #  ###
# # #    #
# # #    #
# # .$ @##
# ###  ###
# #    ###
#$#$ $.###
#.#.   ###
##########