; 396
##########
##########
##  ######
#  $@#####
#$..######
# $ ######
# . ######
#. $######
#   ######
##########