; 76
##########
##########
##########
##########
##### ####
##@$   . #
### $  $ #
#####$ #.#
####  .. #
##########