; 418
##########
#    #####
# $ $#####
###   ####
####.. $ #
####  $  #
### .### #
### @ ##.#
###      #
##########