; 748
##########
##########
##### ####
#  .$@####
#   $ ####
# $ ######
# .#######
#  ###.$ #
#      . #
##########