; 769
##########
# .  . $@#
# . . $ ##
# $$######
#   ######
##########
##########
##########
##########
##########