; 93
##########
##.$     #
##   @   #
##   ##  #
##.#.    #
##$## #  #
##   $   #
###      #
####.$ ###
##########