; 191
##########
#       .#
#  #. $ $#
# $# #   #
# .# #   #
# ##     #
#### #@  #
####    $#
######  .#
##########