; 738
##########
#. #######
#  #######
# ## # # #
#        #
#. $ #$$ #
# ####   #
##.@   $ #
###.     #
##########