; 986
##########
######@###
######$###
##### . ##
#####$  ##
#####  ###
###  .$###
####   ###
###  .$ .#
##########