; 21
##########
#   .#####
#       .#
# ##     #
#.#. $$  #
# #   @ ##
# # $ #$##
#       ##
#      ###
##########