; 83
##########
##       #
## ##### #
## $.### #
##   ### #
##       #
##$$$## ##
##...##@##
##########
##########