; 181
##########
##      ##
## $  . .#
#   ##  $#
#   #    #
#$  #    #
#.  #@  $#
##      .#
##     ###
##########