; 26
##########
# $.######
# $.##   #
#      @ #
####   $ #
#######.##
#       ##
# ########
#  $.#####
##########