; 33
##########
##########
##########
###.####.#
###$   #$#
###    # #
##   @$. #
#      ###
#.$    ###
##########