; 34
##########
#      ###
# $     ##
## $   .##
## ###  ##
## ..   ##
#   #$  ##
# $     ##
#   .  ###
##########