; 61
##########
#  #######
#$  ######
#.   #####
##   #####
## @$. ###
#    # ###
#$   #$###
#.   #.###
##########