; 949
##########
##########
##########
##########
##########
#  .  $ ##
## $$.. ##
##.# #$  #
#     @  #
##########