; 964
##########
###.   $ #
####$ $. #
###@$.   #
###.  ## #
##########
##########
##########
##########
##########