; 44
##########
###     ##
#   ### ##
# ####  ##
# #      #
# # #.$  #
#   #.$  #
### #.$  #
##@ #.$  #
##########