; 908
##########
#@  ######
#$$ ######
#.$#######
#. $. ####
#.  ######
# ########
##########
##########
##########