; 727
##########
###      #
####$$ $ #
#   $@#  #
##.#.### #
#  #   . #
#        #
# .   ####
##########
##########