; 973
##########
##########
##########
##########
######   #
##### $$.#
###@$   .#
####  . $#
##### .  #
##########