; 17
##########
###   .  #
### $##  #
###  ##  #
###    @ #
###$ #   #
###.  .  #
####$ $ ##
####.   ##
##########