; 110
##########
#.$   .###
# $$. ####
#  ## ####
# ####  ##
#.####  ##
#       @#
#  ## $ ##
######   #
##########