; 969
##########
###### . #
######@$ #
###### $##
######$ ##
######  .#
######$  #
#####    #
#### .  .#
##########