; 197
##########
#.   #.$ #
# #$     #
# #  .## #
# #  $## #
# #      #
# # # #. #
#   @ #$ #
#     #  #
##########