; 975
##########
#     ####
# $$@#####
## .######
## .######
##$$ #####
##   #####
### .#  ##
#  .     #
##########