; 62
##########
####@#   #
#### # # #
#### # # #
####   # #
##   ### #
## ###.. #
#   $.$$ #
#.$      #
##########