; 77
##########
# $.   ###
# ##   ###
#   @ $. #
#      # #
#  ##### #
# $# $.# #
# .# ### #
# ##     #
##########