; 174
##########
#      ###
# #### ###
#  $.# ###
#  $.#   #
#$ $.# # #
#. ###   #
## #@# ###
##     ###
##########