; 73
##########
#.$    ###
#   #  ###
#  # @$. #
# $.   # #
###### # #
###### # #
######## #
######.$ #
##########