; 7
##########
##     .##
##   #  ##
#. $ #   #
#     @  #
#     $  #
#   $##  #
## $  #  #
### .  .##
##########