; 544
##########
##########
#  #######
# $..  ###
# .$  ####
# ##$$####
# ##  ####
#@ ##  ###
#    . ###
##########