; 896
##########
#     ####
# # $.####
#  # $####
# # @ ####
# #$.#####
# $  #####
# .. #####
# #  #####
##########