; 372
##########
##  #### #
## $     #
##     . #
######## #
# ##### @#
# . ### .#
# $ ## $ #
# .  $   #
##########