; 48
##########
##########
##.$    .#
#     . $#
#   ## # #
#$  @ $  #
#.       #
##########
##########
##########