; 166
##########
### #### #
#  . $ . #
##.$   $ #
#   #### #
#.  ###  #
#  ####  #
# $#####@#
#  ##### #
##########