; 501
##########
# ##    ##
# $    . #
#@#.   $ #
#  #######
# .   $. #
#    #   #
#######$ #
#######  #
##########