; 26
##########
# $.######
# $.##   #
#      @ #
####   $ #
#######.##
##      ##
##$#######
##.#######
##########