; 226
##########
##########
##########
##########
# ########
#  #######
#$  ## # #
# .. $ $ #
#.  $  .@#
##########