; 479
##########
##########
##########
##########
##########
##########
### .##  #
# $ $$ $.#
# .   .@ #
##########