; 411
##########
# ########
#   ######
# .#  ####
#    $   #
# .$.. $ #
#######  #
#######$@#
#######  #
##########