; 36
##########
#      ###
#    . ###
#  ##  ###
#   #  ###
# @  $ $.#
#        #
#####   $#
#####.$ .#
##########