; 775
##########
### ###@ #
#   ###$$#
# $ ###  #
#  ###  .#
#     #  #
# .   # $#
####  # .#
####  .  #
##########