; 40
##########
## @    ##
##       #
#.  # # $#
# $  .#  #
#   # # .#
#$ $#   ##
#   #  ###
#    .####
##########