; 538
##########
#####  ###
##### $ ##
#####  @##
######$.##
### .. ###
#### $ # #
####   $ #
#      . #
##########