; 179
##########
#        #
# ###### #
# #  #.$ #
# #  #####
# #   .$ #
# .$ @#  #
###  #   #
##     $.#
##########