; 27
##########
##.$  $.##
##      ##
### #   ##
#.###   ##
#$# .$ @##
# # #  ###
# # #  ###
#   #  ###
##########