; 651
##########
# #.# ## #
#       .#
# $    $ #
# #####  #
######## #
##### ##.#
# . $@$  #
##  #    #
##########