; 91
##########
#  .######
#. $@#####
# $.######
# $#######
#  #######
# $#######
#. #######
## #######
##########