; 171
##########
###   ####
### # ####
#        #
# ###### #
# @#...# #
# ##$$$# #
#      # #
###.$    #
##########