; 140
##########
##########
##. $.####
##$   @$.#
##   #   #
### $    #
### ###  #
###.     #
##########
##########