; 38
##########
####### .#
######  $#
###.$    #
####     #
##.#  @  #
##$#  $  #
## ###.###
##     ###
##########