; 613
##########
#..#######
# $#######
#  .  ####
# #.  ####
#$ # #####
#    #####
# $$ #####
#  @ #####
##########