; 108
##########
##       #
##$##### #
##.##    #
#####.####
###  $  .#
#       $#
#    @ # #
#.$      #
##########