; 158
##########
######.$ #
#.$  ##  #
#.$      #
#    # @ #
##   ##  #
##   ##$ #
### .    #
###      #
##########