; 119
##########
#   #  ###
# # #  ###
# # #  ###
# # .$ @##
# ###    #
# ###    #
#$#   #  #
#.#.$  $.#
##########