; 6
##########
##########
##########
#   @  ###
# $    ###
#  #   $.#
# .      #
#      $$#
###### ..#
##########