; 73
##########
#@     ###
# ##    ##
#    $ . #
#     #  #
#  #  #  #
#  .  #  #
#$ $    $#
#.      .#
##########