; 127
##########
#      ###
#  $ #####
# ########
# ########
# .  . $@#
#    $ $ #
#..#######
#  #######
##########