; 66
##########
#.      .#
#$ #### $#
#  #@    #
#      ###
#  ##   ##
#        #
#$  $##  #
#.   .   #
##########