; 6
##########
######  .#
### @   $#
###    # #
### $    #
####.#$  #
#    #.  #
# ########
#      $.#
##########