; 293
##########
##       #
##  $@$$ #
###.###.##
### ######
##. ######
## .######
##$ ######
##       #
##########