; 86
##########
#.$    $.#
#    #####
##   #.$ #
## @ ### #
#     #  #
#  $  # ##
###.### ##
###     ##
##########