; 713
##########
#   ### ##
#   ..  ##
# $   $ ##
#  #######
# $#######
## .######
# $ ## ###
#      @.#
##########