; 212
##########
###   @  #
### ##$$##
###### .##
###### .##
#   ## $.#
#  ###  ##
#  ### $##
#.       #
##########