; 92
##########
#  #######
#  ##  ###
#  .$  $@#
# $. $ ###
#. #######
# ########
#  #######
#. #######
##########