; 32
##########
#.$      #
######## #
##     # #
##.###   #
# $   ####
#        #
# @ ##.$ #
######.$ #
##########