; 937
##########
##########
##########
##########
#.#   ####
#  $ $ $@#
#  .. $ ##
#.##### ##
#       ##
##########