; 371
##########
#  . $   #
##@$ $.. #
#######. #
###### $ #
######   #
#######  #
######## #
######## #
##########