; 537
##########
#  .  $ ##
#  .$ $@##
#.########
#  #######
# $     ##
#       ##
#  ##.  ##
# ########
##########