; 448
##########
##########
#@ #######
#$$#######
#  #######
# $###  ##
#  ### $ #
#. ###  .#
#  ..   ##
##########