; 76
##########
#.$    ###
#     . ##
#  ###   #
#     $  #
#        #
# $.#  # #
#      # #
#.$     @#
##########