; 47
##########
####    ##
### $ .@##
#     $ ##
# .$ # ###
#  ## .###
#  ##   ##
##  # $ ##
##. #  ###
##########