; 198
##########
##########
### ######
# #     ##
# $ $@$ .#
# # ..   #
# #   $  #
#  ####  #
#      . #
##########