; 812
##########
##########
##########
##########
##########
##########
#  . #####
# $$. $ ##
#  ..  $@#
##########