; 974
##########
# .$@.  ##
#   $ $ ##
#  #######
#$########
# ########
#  #######
#.########
#.########
##########