; 30
##########
##########
##      ##
#  .    ##
#  $.#   #
#   ##.$ #
# $.###  #
#    $  ##
##     ###
##########