; 114
##########
##########
####.#####
##.#  ####
##  $ ####
##   #####
## $######
##$ $ ####
# . .@ ###
##########