; 162
##########
#.    .$ #
# $ . $$ #
###### . #
#######@##
##########
##########
##########
##########
##########