; 6
##########
######  .#
###     $#
### @    #
### $  ###
####.#$###
#    #.###
# ########
# $.######
##########