; 191
##########
#    $.###
# ######.#
# ###   $#
# #   #  #
# #   #$ #
# .$ @#. #
###   ## #
###  #####
##########