; 720
##########
# $  . ###
#.     ###
# ##  ####
#####$# ##
####  $ ##
#### $@.##
#### . ###
####  ####
##########