; 106
##########
#.$      #
#    @ # #
#       $#
###  $  .#
#####.####
##.##    #
##$##### #
##       #
##########