; 845
##########
######## #
### ###  #
### ## # #
#    .   #
# $ .  $ #
##$.## ###
##  #  ###
### . $ @#
##########