; 78
##########
###      #
#@#  #   #
# #  ##  #
#    ### #
# ####.$ #
# ####.$ #
# ##.$   #
#      $.#
##########