; 136
##########
###      #
###.#### #
## $   # #
##    ## #
#  @ #.$ #
# ## #####
#  $.    #
#     .$ #
##########