; 105
##########
##.$ $.###
#       ##
#.$ @   ##
####    ##
###   #. #
###  ##  #
###    $ #
####     #
##########