; 29
##########
###.$  .##
##     $##
###  #  ##
###@    ##
###    $##
###    .##
### $#  ##
##   .  ##
##########