; 40
##########
#      $.#
# ########
#    # $.#
####.#   #
#   $  $ #
#      . #
##  @#####
##  ######
##########