; 351
##########
#  @  ####
# .$$#####
####  ####
####  ####
#### $####
#### . ###
#  #  ####
# .  $  .#
##########