; 996
##########
##########
##########
###  .  ##
#  $ . $.#
#  $   $@#
# .#######
#  #######
# ########
##########