; 69
##########
##.$     #
######## #
###.   # #
###$   # #
###    # #
#    @$. #
#$ ##  ###
#.    ####
##########