; 194
##########
##########
#  #######
# $ ## .##
#   $ $ ##
# $.  . ##
#  #### ##
#  #######
#@      .#
##########