; 186
##########
#.$    $.#
#        #
#  @   $ #
## # ##  #
##     . #
######## #
#####.$  #
####     #
##########