; 610
##########
##       #
## $     #
#######  #
#  ###@ ##
#  ###$ ##
#   ##.  #
#  ###$ ##
#.   .$. #
##########