; 74
##########
#      ###
#   #  #@#
#  ##  # #
# ###    #
# $.#### #
# $.#### #
#   $.## #
#.$      #
##########