; 623
##########
####  ####
#  #.  ###
#. $$ ####
# $@   ###
# ###. ###
#     . ##
# $     ##
#####  ###
##########