; 999
##########
#@$ .  .##
# $ $ $ ##
# ###.   #
#######.##
##########
##########
##########
##########
##########