; 81
##########
##########
##@##...##
## ##$$$##
#       ##
# ###   ##
# ###.$ ##
# ##### ##
#       ##
##########