; 157
##########
#        #
#$  @ $  #
#.#  ##  #
### ###  #
##     . #
##       #
##$$   ###
##.. #####
##########