; 60
##########
#      $.#
# $$.$   #
# ..### ##
# ###   ##
# #   ####
# # # ####
# # # ####
#   #@####
##########