; 795
##########
##########
##########
##########
##########
#      ###
#.# $ #  #
#$$. ##$ #
#  .  @. #
##########