; 35
##########
#      ###
#    @ ###
#  #   ###
#  ##  ###
# .  $  .#
#       $#
#####$   #
#####. $.#
##########