; 59
##########
#     $.##
#       ##
#$ #   ###
#. #  @###
##. $  ###
###   ####
#####  ###
##### $.##
##########