; 169
##########
#.    ####
#$ ##  ###
#  #@ $. #
#  #   # #
#$ #   # #
#.     # #
######## #
#.$      #
##########