; 151
##########
####.$ $.#
##       #
#  ## #$$#
# ### #..#
# #@# ####
# #      #
# ###### #
#        #
##########