; 621
##########
#   ######
# #.     #
# # # .$$#
# #####$.#
# ##  #  #
# $      #
# ##  # .#
#@ #######
##########