; 957
##########
##     .##
### $ $$##
####@$  ##
#####   .#
#####   ##
#####    #
######.  #
#####   .#
##########