; 967
##########
# ..$ . ##
# $#   ###
# . ######
#   ######
# $ #### #
#  ##    #
# $ #    #
#   @    #
##########