; 64
##########
###  $.###
###.######
## $   ###
#  @   ###
# #    ###
# #  $.###
#   ######
#.$ ######
##########