; 34
##########
# $.######
# $.## @ #
#        #
####   $ #
#   ###.##
# #     ##
# ########
#      $.#
##########