; 38
##########
#. $.#####
#$   #####
#        #
#.$ $  @ #
###  #   #
###  ##  #
### .    #
###      #
##########