; 258
##########
##########
##########
####### .#
#######  #
#. ##### #
#   #    #
#$$# $ # #
#@$. .   #
##########