; 743
##########
##########
##########
#.###.#  #
# $     .#
# $ #  . #
# # ######
# $$######
#@  ######
##########