; 264
##########
#     ##@#
##     $$#
##  $ #  #
### ### .#
##.  ##  #
## $  ####
##   . ###
###.  ####
##########