; 71
##########
#....    #
#$$$$    #
#      # #
# ###### #
#    @## #
### #### #
### #    #
###      #
##########