; 113
##########
###  #   #
###  # # #
###  # # #
##@ $. # #
#    ### #
#    ### #
#  #   #$#
#.$  $.#.#
##########