; 172
##########
# $  .   #
# .   $ ##
#  #######
# ########
#. #######
# $#######
#  $@#####
# .  #####
##########