; 41
##########
#     ####
#        #
#$$$$  # #
#.... ## #
##### ## #
#     #  #
#@# ### ##
###     ##
##########