; 284
##########
####.  $ #
#####  $ #
#####. $ #
#######  #
#  ####  #
# $  ## ##
#    #   #
##@ ..   #
##########