; 94
##########
##########
### $.  .#
##  ##  $#
#.  #.   #
#$ $  #@ #
#   # #  #
##       #
##       #
##########