; 424
##########
#       ##
#@$ $.$###
#  ##  ###
#  ###  ##
# $## .. #
#  ## .  #
# ###### #
#  #######
##########