; 979
##########
#  .     #
#  # # $ #
# #### .##
# ####  ##
# .### ###
# $  $ $ #
#     @ .#
##########
##########