; 20
##########
###   .  #
#@$  $  .#
##   ### #
#######  #
#######  #
######## #
# ####   #
#  ..$ $ #
##########