; 187
##########
#        #
# ###### #
# #@   # #
# ## # # #
#    # # #
#.$ $#   #
#.$ .# # #
#.$ ##   #
##########