; 785
##########
####     #
#### .$  #
##### $ ##
#@####  ##
# ####. ##
#  ###. ##
# ####$$##
#     .  #
##########