; 578
##########
####@.   #
####$. $ #
####   ###
#### $####
####  .###
####  ####
#### $####
####.    #
##########