; 226
##########
##.$   ###
##    ####
#.  @#####
#$ #  ####
#   $   ##
####.#####
#### #####
####   $.#
##########