; 346
##########
##########
##########
##########
# $.######
# $.  ####
#@$. #####
##$  ##  #
#  .     #
##########