; 432
##########
#  $ .   #
#  . $ $ #
# ##@  ###
#  #######
#.$#######
#  #######
#  #######
##. ######
##########