; 66
##########
###### $.#
######   #
###.$  # #
###    # #
###   @  #
#.#   $ ##
#$####.###
#      ###
##########