; 213
##########
###.$ $.##
###      #
### # ####
###@ $.  #
####  ## #
##### ## #
##### ##$#
########.#
##########