; 963
##########
### ##  ##
#  . $ ###
# $   .###
# ########
#.## #####
#. $   $ #
#      #@#
##########
##########