; 225
##########
########.#
##### ##$#
# ### ## #
#  #  ## #
#  @ $.  #
#$  # ####
#.    ####
###.$ ####
##########