; 41
##########
#.     ###
#$     ###
#    @$. #
#$     # #
#.######$#
########.#
##########
##########
##########