; 75
##########
###   .$ #
###   ## #
# .$ @   #
# #      #
# #####  #
# #.$ #$ #
# ### #. #
#     ## #
##########