; 195
##########
#    $.###
# ##    ##
# ## $$$##
#  # ...##
## # #####
#  # #####
# ## #####
#     @###
##########