; 536
##########
#@       #
# .  $ # #
# #####  #
#. ### . #
#  ###   #
# $ ###$ #
# $     ##
#    ##.##
##########