; 13
##########
##    $.##
##      ##
##    ####
## @ $.  #
#     ## #
#     ## #
#$ ##### #
#. #.$   #
##########