; 110
##########
#        #
# ###### #
#    ### #
#### #@# #
#.$  #   #
#.$  ##  #
#.$      #
#.$ ######
##########