; 13
##########
##    $.##
##    $.##
##    ####
### @$.  #
###   ## #
###   ## #
######## #
######.$ #
##########