; 13
##########
#  #######
# $ ######
#  #######
# $.######
#..#  # ##
#@$$  .  #
#  #     #
# ###### #
##########