; 143
##########
#####    #
###   #  #
# .$ @#$ #
# #    . #
# #  ##  #
# # #.# .#
# ###$# $#
#     #  #
##########