; 15
##########
#      ###
# .  $ ###
#  ##  ###
#      ###
#  @   ###
#      ###
#$.$   ###
#.##.$ ###
##########