; 509
##########
##########
####@  ###
#.  .$ ###
#  #   ###
#  ### ###
#. ###  ##
# $.  $$ #
#        #
##########