; 135
##########
##########
# ########
# ##  ####
# ##   ###
#  ##.####
# $  $ $@#
#.  .  $ #
# .#   # #
##########