; 43
##########
##     ###
## ### #@#
#  #     #
# ## #####
# ## ....#
# #  $$$$#
#        #
####     #
##########