; 885
##########
#  #######
# $#######
#   ######
#.$#######
# $.######
#. #######
# $@######
# .  #####
##########