; 3
##########
#.$      #
#.$  ### #
#.$  #   #
#.$  # ###
#    # ###
#    # ###
### ## ###
###    @##
##########