; 321
##########
##########
##########
##########
####.#####
####$  # #
## .$ .$ #
##@$   . #
#######  #
##########