; 198
##########
#       ##
# $##  $.#
# .#  #  #
##### @  #
#.##     #
#$##  $  #
# ####.###
#      ###
##########