; 618
##########
##########
### .#####
###    $ #
### $. . #
#######$.#
###### @ #
###### $ #
######   #
##########