; 70
##########
#.$ ######
#   ######
# #  $.###
# #    ###
#  @   ###
## $   ###
###.######
###  $.###
##########