; 674
##########
##### # .#
#####  $ #
####@$$  #
#### $...#
#######  #
##########
##########
##########
##########