; 138
##########
#   #  ###
# $ # .  #
#@ ##   ##
##$##  ###
#   # . ##
#   ## ###
# $$     #
# .   .###
##########