; 523
##########
######   #
######$$.#
######   #
##### $# #
#####  $ #
####  # @#
# ##  ## #
# ..    .#
##########