; 117
##########
# $ .    #
# $ $ . .#
#@ ####  #
#######  #
#######$.#
#######  #
######## #
##########
##########