; 884
##########
#    #####
# $ ######
# ########
# .### @##
# $ # $ ##
#   . $ ##
#.# .  ###
#####  ###
##########