; 22
##########
##. $.####
##$ ######
##   #   #
##   # # #
# @  # # #
# $  # #$#
##.### #.#
##     ###
##########