; 71
##########
####    .#
###  ## $#
# .$@    #
# #    ###
# #   $###
# #   .###
# ########
# $.######
##########