; 232
##########
#####.# ##
#####$# .#
##    # $#
##.####  #
# $      #
#      ###
# @  $####
#    .####
##########