; 701
##########
#### .   #
### .# $.#
###  ##  #
####  ## #
##@# $   #
##$# #   #
#  $  ####
#.   #####
##########