; 636
##########
#..  ## @#
#.    $$ #
#     .$ #
#######$ #
#######  #
######## #
##########
##########
##########