; 181
##########
# ########
# .#######
#  #@#####
#  $$  ###
#. #.# ###
# $.######
# $ ######
#   ######
##########