; 732
##########
##########
#  #######
#.########
#.  #. ###
# $ .$ ###
#$   $  ##
# #### ###
#@     ###
##########