; 171
##########
##########
#   @. ###
##.#$ ####
##   $ ###
#..##  ###
#   #  ###
# $  $####
#     ####
##########