; 767
##########
#  ###  ##
#  ##  ###
# @##$ ###
# ### . ##
#  ##$ ###
# $# . ###
# .  # ###
# $  . ###
##########