; 976
##########
#@$    ..#
# $ $ .$ #
# ###### #
######   #
#######  #
#######  #
####### .#
######   #
##########