; 978
##########
#        #
# $$.   .#
# $ ######
# #  #####
#.## #####
# #  #####
#. $ #####
# @  #####
##########