; 38
##########
######.$ #
# @ ##.$ #
#        #
# $   ####
##.###   #
##     # #
######## #
#.$      #
##########