; 46
##########
##  ######
##  @#####
#      . #
#   $  $ #
####.#   #
#    # $.#
# ########
#      $.#
##########