; 932
##########
#.     # #
# .@  .  #
#    $ # #
# $#######
#  #######
# ########
#  $    ##
#. $   ###
##########