; 101
##########
###    $.#
###   $###
###  #.#.#
##   ###$#
##@ $. # #
##   # # #
##   # # #
###  #   #
##########