; 955
##########
## . @ ###
#  $    .#
#  #.    #
#   # #  #
##$ ###  #
##  ###$ #
##$ ###  #
##  ####.#
##########