; 877
##########
####  $. #
#####..$ #
#######  #
###### $ #
######.  #
###### $ #
#######@##
##########
##########