; 568
##########
###.     #
#### $ $.#
# # .### #
# # $@## #
# $. ##  #
#    ##  #
# ###### #
# ###### #
##########