; 2
##########
#   ######
# # ####@#
# #      #
# ###### #
#      # #
#        #
#$$$$  ###
#....  ###
##########