; 37
##########
#   #    #
#$$ # ## #
#.. #  # #
###  # # #
###  # # #
##   # # #
##@ $. #$#
##   ###.#
##########