; 927
##########
#     ####
#    $ ###
### . $###
###  # $@#
###      #
###   ## #
###.$##  #
###  .  .#
##########