; 170
##########
###.     #
###  #   #
#### ## $#
### $### #
### .##  #
###  ## .#
## $$@#  #
## .  ## #
##########