; 310
##########
####### ##
####### ##
#######. #
#@.     ##
# .   $.##
# $  #####
# $$  ####
#     ####
##########