; 53
##########
#.$ ######
#   ######
#   ######
# #  #####
#$#@$. ###
#.#  # #.#
#    # #$#
#    #   #
##########