; 134
##########
#.$      #
####   $.#
##     ###
## @ # #.#
##     #$#
## $   # #
###.#### #
###      #
##########