; 35
##########
###    $.#
###      #
# .$@   ##
# #    ###
#$#   $###
#.####.###
##########
##########
##########