; 633
##########
##########
##########
#    #####
#..   $@##
#  #$#####
# . $ $ ##
#   .   ##
##########
##########