; 495
##########
##########
#.$. #####
# $ ######
#  #######
# $#######
#@ #######
# $ ######
#.. ######
##########