; 76
##########
###.$  ###
######.###
###   $  #
##### @  #
#####  # #
#####.#  #
#####$  $#
#####   .#
##########