; 874
##########
# .    @ #
# $      #
#  ####$ #
# #####  #
# . ..$$ #
#        #
## ##### #
## #######
##########