; 456
##########
##########
##########
###### ###
##@#.  . #
## $$ .# #
## $  ## #
###$  .  #
###      #
##########