; 64
##########
####.### #
####  .$ #
####   $ #
###### $ #
####### .#
#######$.#
#######  #
########@#
##########