; 10
##########
####  . ##
##.  $ @ #
##  ##$  #
##.      #
######   #
#######$ #
###      #
##   $ . #
##########