; 241
##########
######  @#
#######$$#
####### .#
#######..#
#######  #
#######$$#
#######  #
#.       #
##########