; 103
##########
#   #  ###
# # #   ##
# # #   ##
# # .$ @##
#$###   ##
#.#.#  ###
###$   ###
#.$    ###
##########