; 39
##########
##########
##########
#.####.###
#$#   $###
# #    ###
# .$@   ##
###      #
###    $.#
##########