; 84
##########
#        #
#      ###
#  ##.  ##
#  ###   #
#   # $  #
#        #
#$  #  @ #
#.  .$ $.#
##########