; 717
##########
# # ######
#   .  ###
# $ $ ####
#  #  ####
# ##  ####
#  #  ####
#@$## $.##
#   . . ##
##########