; 11
##########
#.##.$ ###
#$.$   ###
#      ###
#  @   ###
#      ###
#  ##  ###
# .  $ ###
#      ###
##########