; 17
##########
#####  ###
#.$  @$. #
#      # #
#$#    # #
#.###### #
#####.$  #
##########
##########
##########