; 67
##########
##########
##########
#.#   .###
#$#   $###
# #    ###
# .$@    #
###  ## $#
####    .#
##########