; 39
##########
#####. $.#
#####$   #
#       $#
# .  $  .#
#  ##  ###
#  #   ###
#    @ ###
#      ###
##########