; 22
##########
##  $.#.##
##  #  $ #
##       #
##@      #
#    #####
# $  #   #
##.### #$#
##     #.#
##########