; 800
##########
#  #######
#  #######
# ########
#  # #####
#    $@$ #
#. # $ $ #
#.##### .#
# .      #
##########