; 176
##########
###      #
# #.#### #
#  $   # #
#      # #
# #@ ### #
#  #.#.# #
#$  $#$# #
#.   #   #
##########