; 420
##########
##      ##
### $.. ##
###.#$$ ##
##  #@  ##
###  #####
#.  ######
#  $ #####
#     ####
##########