; 78
##########
#  .  ####
#. $$#####
#.#$ #####
#@#   ####
# ## #####
# #    ###
#  . $ ###
#        #
##########