; 154
##########
# ########
#. #######
# ######.#
#  # .## #
#@$$  #  #
#  #   $ #
#  #$    #
#  #.  ###
##########