; 9
##########
#        #
# ###### #
#$#   ## #
#.#   ## #
### @$.  #
##    ####
##    $.##
##    $.##
##########