; 61
##########
#  ##.$  #
#$  #### #
#.   ### #
##   ### #
## @$. # #
#    # # #
#$   # # #
#.   #   #
##########