; 68
##########
#      ###
#$####.###
#.#   $ ##
###   @  #
###    # #
###.$  # #
######   #
###### $.#
##########