; 16
##########
##     ###
##.### ###
# $  # ###
# @  # ###
##   # ###
##   # $.#
##$ ######
##. $.####
##########