; 52
##########
##.$     #
######## #
#####    #
#####.####
#### $   #
#    @   #
#$  ###  #
#.   $.  #
##########