; 67
##########
#.$    $.#
#        #
#   # ## #
# $ # @# #
#.#    # #
# #    # #
#    #   #
#   ## $.#
##########