; 91
##########
##       #
##  #### #
## ##### #
## ##### #
##       #
#    ## ##
#$$$$## ##
#....##@##
##########