; 923
##########
##########
##########
##########
# @#######
# $###..##
#    .$  #
# $$.#   #
#   ######
##########