; 112
##########
#.$      #
#   $.$$ #
# ####.. #
#    ### #
## # ### #
##@# ### #
####     #
##########
##########