; 770
##########
# .  .   #
# $ ##   #
#  ##  # #
# .##   .#
# #### $ #
# ####$$ #
#  ###@ ##
# ########
##########