; 930
##########
#        #
##.  $.. #
# $ ####.#
#@$ ###  #
# $ #### #
#  #######
# ########
##########
##########