; 431
##########
# .    ###
# $.   ###
## . #####
##$.######
##  ######
### ######
###$   $@#
###   # ##
##########