; 41
##########
#.     ###
#$     ###
#    @$. #
#$     # #
#.###### #
####.### #
####$### #
####     #
##########