; 161
##########
##.$ $.###
#        #
# .$ $.# #
# ##  ## #
# #####@ #
# ##   # #
# ## # # #
#    #   #
##########