; 572
##########
#    #####
# $.@#####
# $.######
#    .####
# $$.#####
# #  #####
#  #######
#     ####
##########