; 646
##########
# #@  ####
#  $ #####
# $$ #####
#..$ #####
#   ######
#. .######
#  #######
# ########
##########