; 163
##########
####@   ##
##      ##
## $    ##
# .###  ##
#  ###   #
#$       #
#.     $$#
#####  ..#
##########