; 44
##########
#####. $ #
##    @  #
##  $    #
#### ##  #
##  . #  #
#        #
#. $     #
#### $  .#
##########