; 43
##########
##.$   ###
#      #@#
#.   $   #
# ###  $##
#      .##
#       ##
#        #
#####  $.#
##########