; 12
##########
#   $   .#
#       .#
# $# @  ##
#  . #   #
#  #   ###
#$     ###
#    $####
#.     ###
##########