; 450
##########
#.    @  #
# $$ #  .#
# .####$ #
#  ####  #
#######$.#
#######  #
##########
##########
##########