; 589
##########
#.   #####
#  $  ####
# ## #####
# ########
#  #######
# $#### .#
# .$ .$  #
#       @#
##########