; 4
##########
#  .   $ #
# $  $   #
# $@###. #
# .####. #
#  #######
# ########
# ########
# ########
##########