; 496
##########
##########
####@# ###
#   $  ###
#.$   .###
#  ##$ ###
# ### #  #
#$## .## #
#     .  #
##########