; 30
##########
# ########
#  #######
#. #######
#.########
#   . $@##
# $ $$####
# ##   ###
#.     ###
##########