; 726
##########
#        #
# .   .$ #
# ####  ##
#.###  ###
##### $###
#####  ###
##@$  $###
### .  ###
##########