; 58
##########
# $.## $.#
#        #
##   @   #
###  $   #
#####.####
#####    #
######## #
##.$     #
##########