; 192
##########
###.    .#
###$ # $ #
##  ###  #
###.###$ #
##  ### @#
#    #####
##  $#####
#   .#####
##########