; 9
##########
##.$     #
######## #
###   ## #
###   ## #
### @$.  #
##    ####
##    $.##
##    $.##
##########