; 28
##########
#  $  .###
#       ##
#       ##
#$ #. #  #
#. ## #$ #
##  ###  #
##$ .@   #
##       #
##########