; 24
##########
#####.$  #
######## #
##       #
##.#######
# $   ####
# @      #
#   ##.$ #
######.$ #
##########