; 172
##########
#.$     ##
#        #
### .#   #
##  ###  #
## $###  #
#        #
#    @ $.#
# $.######
##########