; 323
##########
####     #
##### $. #
###### .##
#####   ##
#####.$  #
##### $. #
#######$ #
#######@ #
##########