; 765
##########
#      . #
# $  #   #
#   ###  #
#.$ ##   #
##   # $ #
###  ##  #
## $ #@###
##. .  ###
##########