; 745
##########
##########
##########
##########
##########
# .   ####
# $#$$.###
#.$.@  ###
#      ###
##########