; 104
##########
#.$ .### #
#    ##  #
# .####$ #
#@$   .  #
#  #  #  #
####   $ #
#####  # #
##########
##########