; 209
##########
########.#
##### ##$#
##### ## #
####  ## #
###@ $.  #
### # ####
###      #
###.$ $.##
##########