; 662
##########
#  #  ####
# $..    #
#  #     #
# $##### #
# . .$@$ #
#     ## #
##########
##########
##########