; 81
##########
#. ##  ###
#$     ###
#   @ $. #
#      # #
# ###  # #
# #.#### #
#$#$#    #
#.#   ####
##########