; 376
##########
#@ #######
#  #######
#  #######
# #####  #
# ### #  #
# $ . .  #
# ###$$ ##
# $.   . #
##########