; 17
##########
#####  ###
#   @ $. #
#      # #
#$#    # #
#.   ### #
##   #   #
#.$  # ###
##   # $.#
##########