; 317
##########
##########
##########
###  #####
###  #####
### $#####
####  ####
# $  . $ #
#.  .. $@#
##########