; 864
##########
######   #
###### $ #
#######. #
###### $ #
####@$. .#
#### $.  #
##########
##########
##########