; 113
##########
#####   .#
###@  # $#
##### #  #
##    #$ #
## ####. #
## ###.$ #
## ###.$ #
##       #
##########