; 830
##########
#  #######
# #   ####
#  #$ ####
# $.$@####
# $ .#####
#..  #####
# ########
#  #######
##########