; 602
##########
##    . .#
## $  #. #
##@ ###  #
## $###  #
##   ##$ #
## $ ##  #
##  .#####
##   #####
##########