; 127
##########
##   @####
## # #####
#  #     #
# $# ### #
# .###   #
# $..# # #
# $.$#   #
#       ##
##########