; 142
##########
##########
#     .###
#  ### ###
#    $ ###
#   #   ##
#.$@   $##
####.$ .##
##########
##########