; 40
##########
##########
##########
# #### ###
#     @  #
#.$ .$ $ #
#  #######
#$ #######
# .   . ##
##########