; 794
##########
#   .  @ #
# $$   $ #
# #   .. #
#.$ ######
#   ######
##########
##########
##########
##########