; 773
##########
##########
######@###
######$ ##
#### . $##
#####   .#
###### $ #
# $   . ##
#.       #
##########