; 946
##########
## # .  .#
##   $$. #
##    #$ #
######   #
####### .#
#######$ #
#######@##
##########
##########