; 23
##########
###  #####
# .$@  $.#
# #      #
#$#    #$#
#.######.#
##########
##########
##########
##########