; 20
##########
###      #
#    @   #
# $.  ##.#
#   # ## #
#.$    $ #
###.$    #
##########
##########
##########