; 49
##########
#    #   #
#    # # #
#.#  # # #
#$#@$. # #
# #  ### #
#   #    #
#   #$####
#.$ #.####
##########