; 23
##########
###.    ##
#.   #  ##
# ####  .# 
# ####   #
#  $     #
#$ @  $  #
#  $###  #
#    .   #
##########