; 203
##########
###    $.#
###      #
# .$ @## #
# #    # #
# #  # # #
# ##     #
#$#####$ #
#.#####. #
##########