; 73
##########
##@      #
#### ### #
#    ### #
#    ##. #
# #####$ #
#  ##..  #
#   #$$ $#
#       .#
##########