; 988
##########
#####  . #
#####$#$ #
####   $@#
####   # #
##### ####
#### .  ##
####  # ##
# .   $. #
##########