; 860
##########
#  .$ ####
#   .$@###
#  # #####
# $#######
#. #######
#. #######
# $#######
#  #######
##########