; 320
##########
##########
##########
##########
##########
##########
####.# . #
####$$ $ #
#  .@ $ .#
##########