; 39
##########
###   $.##
#   ######
# ####.###
# #   $###
# #    ###
# .$@   ##
###      #
###    $.#
##########