; 81
##########
# ########
# ########
#  #######
#.$ ######
#   ######
#.$.######
#$ $@#####
# . ######
##########