; 236
##########
## #.#####
#. #$#####
#$ #    ##
#  ####.##
#      $ #
###      #
####$  @ #
####.    #
##########