; 305
##########
#   ######
# .$######
#     ####
#  $.$####
# ##.$ ###
#. #@   ##
#  ###   #
#        #
##########