; 51
##########
####.# $.#
####$#   #
#    #   #
# ###  # #
# # .$@#$#
# # #  #.#
# # #    #
#   #    #
##########