; 57
##########
#.   #.###
#$   #$###
#    # ###
## @$. ###
##   #####
#.   #####
#$  ######
#  #######
##########