; 16
##########
#.... ####
#$$$$    #
#     ## #
# #  ##  #
# ####  ##
#      ###
# ########
#@########
##########