; 177
##########
##     ###
##      .#
#.  #@  $#
#$  #    #
#   #    #
#   ##  $#
## $  . .#
##      ##
##########