; 28
##########
##########
##########
####.$  ##
#######.##
####   $ #
#      @ #
# $.##   #
# $.######
##########