; 870
##########
###  #####
###   .# #
### . #  #
#     #$ #
# $ $ #  #
#   #    #
####@$ # #
##### . .#
##########