; 327
##########
# ..  @ ##
# $$ $ ###
# .#######
#   ######
# $#######
#  #######
# . ######
#    #####
##########