; 842
##########
######   #
#######$ #
#####@#  #
#.  .$  .#
## $   $.#
#######  #
######## #
##########
##########