; 14
##########
##   @ . #
##$ # $$ #
#  #### ##
#    $  ##
##.#  .  #
#######. #
#######  #
##########
##########