; 358
##########
#        #
#     .  #
##. ######
#. .######
#$ # ### #
#      # #
##$  $ $ #
##@#     #
##########