; 102
##########
#  @######
## $######
###   ####
### $ ####
###   ####
#.# .#####
#.$ $ ####
#.   #####
##########