; 547
##########
## #######
#  ..  $ #
# $ $  . #
#  ## ####
# ########
# ###@####
#     ####
# $ . ####
##########