; 121
##########
#. ####  #
#$ ####  #
#  ####  #
# ######@#
# $ # #. #
#     $$ #
#.#.#    #
#  ##### #
##########