; 36
##########
###  $.###
###.######
#  $  ####
#  @  ####
#     ####
#    $.###
#$  ######
#. #######
##########