; 364
##########
######  @#
# ##    ##
#  # $# ##
# .#   ###
#  ##$ ###
#   #  ###
#..$.$ ###
#      ###
##########