; 9
##########
#.  .#####
#     ####
#   $ ####
#  #   ###
#  ##   ##
#  @  $ ##
#  $   .##
#    $ .##
##########