; 31
##########
##  .   ##
##  #$ ###
##.    ###
##$    ###
##    @###
##  #  ###
##$     ##
##.  $.###
##########