; 86
##########
####     #
##@  ### #
#### ### #
#### ### #
##.$  .# #
##.$  $# #
##.$     #
##########
##########