; 33
##########
# . $    #
# $ . #  #
##   ### #
####### .#
####  #  #
### $  # #
###  $   #
####  .@ #
##########