; 35
##########
###    $.#
###      #
# .$@   ##
# #    ###
# #   $#.#
# ####.#$#
#   #### #
###      #
##########