; 449
##########
##  ######
##$.@#####
#  $ #####
#. .######
##$ ######
##  ######
# $  #####
# .  #####
##########