; 27
##########
######   #
###### $$#
###### ..#
###.#  ###
###$#  ###
### #   ##
### .$@ ##
#####   ##
##########