; 42
##########
####.$ $.#
#####    #
#####    #
#####    #
##### @  #
##### $  #
######.###
###.$  ###
##########