; 880
##########
##########
#@  ######
# .$##.###
# $    . #
##  $   ##
#  #######
#.$ # ####
#        #
##########