; 141
##########
#  #######
# $ ######
#   ######
# $##.####
#. .  # ##
#.  $ #  #
#####@ $ #
####     #
##########