; 46
##########
#.$ $.####
#    #####
#    #####
#    #.$ #
#  @ ### #
#  $ ### #
###.#### #
###      #
##########