; 7
##########
#   ######
#$# ######
#.# #   ##
### .$@ ##
#####   ##
###.$    #
######   #
###### $.#
##########