; 27
##########
#   ##   #
# # ## $$#
#$# ## ..#
#.# #  ###
### #  ###
### #   ##
### .$@ ##
#####   ##
##########