; 1
##########
#.########
#  #######
# $  $@###
# . . ####
# # $$ . #
# #    ###
# ##### ##
#        #
##########