; 665
##########
#  #######
# $#######
#  #######
# $#######
#. #######
#  #######
# $.. ####
#  . $@###
##########