; 7
##########
##########
##########
##  ######
# .#######
# $#######
#  #   ###
# $. $$  #
#@ #..  ##
##########