; 144
##########
###      #
###.#### #
#  $   #$#
#      #.#
#  @ # ###
#     #  #
# ### # $#
# .$    .#
##########