; 991
##########
##########
#.########
# .# #####
#     ####
# @  $####
# ## $ ###
#  #$$ ###
#. .   ###
##########