; 850
##########
##########
##########
##########
#######  #
###@. ## #
# . $ $  #
## $ $ ..#
######   #
##########