; 44
##########
#.$      #
######## #
#.$ #    #
#   #.####
# $  $   #
# .      #
#####@  ##
######  ##
##########