; 152
##########
#######  #
#####.   #
#      # #
#. # .####
# $## ####
#$$  $ .##
#   #@####
##########
##########