; 11
##########
##.$    ##
##.$    ##
####    ##
#  .$@ ###
# ##   ###
# ##   ###
# ########
# $.######
##########