; 553
##########
##########
# ########
#  #####.#
#      $ #
#  . #$$@#
# ####  .#
# #####$ #
#######.##
##########