; 107
##########
######  .#
# $.##  $#
# ###    #
# ###    #
# # .$ @ #
# # #    #
# # #  # #
#   #.$  #
##########