; 75
##########
# $.######
# ########
# # ######
# # ######
# #   .$ #
# .$@ #  #
###  #   #
###    $.#
##########