; 134
##########
#  .######
# $ $@ ###
#  ## ####
# $ ...$ #
#        #
### ######
##########
##########
##########