; 45
##########
######.$ #
######## #
######## #
#.###### #
#$     # #
#    @$. #
#$     ###
#.     ###
##########