; 840
##########
#      ###
# $.@$ ###
#.########
# ########
# .#######
#  ###   #
# $    $ #
#   .    #
##########