; 53
##########
# $.#.$  #
#   #### #
#$  #### #
#.   #   #
##   # ###
###  # ###
# @ $. ###
#    #####
##########