; 84
##########
##########
#     $.##
# #$  $.##
# #.  $.##
# ### ####
# ### ####
# ###  @##
#     ####
##########