; 352
##########
##########
## #######
#    ### #
#..$..#  #
# ## ##  #
# $      #
# $  $ #@#
# # #  ###
##########