; 97
##########
###  #   #
##   # # #
##   # # #
##@ $. # #
##   ###$#
###  #.#.#
###   $###
###    $.#
##########