; 601
##########
##########
##########
##########
#     ####
# ## $ ###
# $ $ ####
#  $ . ###
# @ ..  .#
##########