; 18
##########
########@#
######## #
###      #
##  #### #
#  ##  # #
# ##     #
#    $$$$#
#### ....#
##########