; 96
##########
#####    #
##     $ #
#     #  #
#$     .@#
#.$ #.   #
##. #$  ##
###     ##
##########
##########