; 59
##########
#        #
# $.#### #
# $.#    #
# .## ####
# $#    @#
#  # #####
#$   #####
#. #######
##########