; 111
##########
###.$ $.##
##       #
##   @ $.#
##    ####
# .#   ###
#  ##  ###
# $    ###
#     ####
##########