; 85
##########
##########
#### #####
# $     .#
# ##..   #
#@ ### $##
#  ###$ ##
# # ## $.#
#        #
##########