; 584
##########
#######  #
######   #
######$ ##
######  .#
######$ ##
###### @.#
#### $.$ #
####   . #
##########