; 162
##########
#####  $.#
#      $.#
#        #
#   ##   #
#@  ##  ##
## $##  ##
##  .   ##
####  $.##
##########