; 247
##########
####     #
##### $. #
#######$ #
######   #
###### $.#
#######@ #
#### #. $#
###   .  #
##########