; 888
##########
# ########
# . ######
# $$######
#. $@#####
#  $ #####
#  #######
#  .######
##.#######
##########