; 129
##########
#.########
#$#    ###
# # @ $. #
#      # #
#   #  # #
#      # #
# $##### #
# .#.$   #
##########