; 741
##########
#### .# @#
####.  $ #
#### $ . #
###### $ #
#######  #
#######$ #
####### .#
######## #
##########