; 76
##########
#.$      #
#   $.## #
# $.#### #
# $.#### #
# ###    #
#  ##  # #
#   #  #@#
#      ###
##########