; 14
##########
#  $.#####
# ####   #
# #      #
# #  @   #
# #  $   #
# ###.#$$#
# ### #..#
#     ####
##########