; 19
##########
##   .####
## $ $####
#  .  .###
#   # $###
# @    ###
#  ##  ###
#  ##$ ###
#  .   ###
##########