; 59
##########
#######  #
######  $#
#####   .#
#####   ##
### .$@ ##
### #    #
###$#   $#
###.#   .#
##########