; 51
##########
######   #
###### # #
##   # # #
## @$. # #
##   ### #
#    $.# #
#   #### #
#.$ #.$  #
##########