; 315
##########
##########
##########
#######  #
###### $ #
######  .#
######.$ #
##### $.$#
#  @   . #
##########