; 379
##########
#   # .  #
#$$@#    #
# . ## # #
#.$##  # #
##  #    #
#  ##    #
#  ##  $ #
#   .   ##
##########