; 190
##########
##.      #
###.  $$ #
##. $## .#
## $  ## #
###@######
##########
##########
##########
##########