; 54
##########
#  #######
#  #######
# ## .####
# .#$.####
#@ $   ###
#  $  ####
# $. #####
#   ######
##########