; 73
##########
#.$    ###
#   #  ###
#  # @$. #
# $.   # #
###### # #
## $.# # #
## ##### #
##       #
##########