; 94
##########
#      ###
# .  . ###
# $#.#####
#.  $@####
# $#######
#    #####
# $#######
#  #######
##########