; 469
##########
#     ####
#  .  ####
# .  $@# #
# .# .$  #
##$ #    #
#  ####$ #
#  #     #
#      # #
##########