; 70
##########
###.#.$ .#
###$#   $#
#   #    #
# ### @  #
# ##     #
#  #  $  #
## ###.###
##     ###
##########