; 166
##########
##  ######
##  @  ###
#       ##
#   $  $.#
####.#   #
#    #   #
# ####   #
#  $.#.$ #
##########