; 34
##########
#####.$ .#
#####   $#
#        #
# @  $ $.#
#   #  ###
#  ##  ###
#    . ###
#      ###
##########