; 181
##########
#        #
# ###### #
# $.#  # #
#####  # #
# $.   # #
#  #@ $. #
#   #  ###
#.$     ##
##########