; 400
##########
# .  .   #
#    $@$ #
# ####   #
#  ####$ #
# #####  #
#  #######
# $#######
#.  . ####
##########