; 365
##########
#####    #
####  $. #
####     #
####  ####
#### $####
#####. ###
## $ . $@#
##  .   ##
##########