; 51
##########
#  $.#.$ #
# ####   #
# ####  $#
#   #   .#
### #   ##
### #  ###
### .$ @ #
#####    #
##########