; 389
##########
##########
##########
##########
##  ######
# . .#####
# .$$#####
# $ $@####
# . ######
##########