; 133
##########
##.. #####
##$$ ##  #
##       #
#  # . $ #
#  #  #  #
## @  #  #
##       #
####.$  ##
##########