; 44
##########
#      ###
#$####.###
#.### $  #
##### @  #
#####    #
#####    #
#####    #
####.$ $.#
##########