; 528
##########
#  ####  #
#  ####$@#
# #####  #
# # #. $ #
# $ .  $ #
#      ###
#. #######
#.########
##########