; 38
##########
####  ####
##.     ##
##  $ $ ##
## # @ ###
##$$.  ###
##     ###
##. $   ##
##.    .##
##########