; 8
##########
#     ####
# ### #..#
# ###.#$$#
# #  $   #
# #  @   #
#$#      #
#.####   #
##########
##########