; 10
##########
#####  $.#
#        #
#   @  ###
#      #.#
#   $  #$#
#$ #.### #
#. # ### #
####     #
##########