; 405
##########
#####  . #
##### .$ #
######$ .#
###### $ #
####### $#
#######.@#
##########
##########
##########