; 137
##########
#     ####
#       ##
#$$$$ # ##
#.... # ##
####  # ##
#    #@ ##
# ##### ##
#       ##
##########