; 37
##########
###      #
### #### #
#@     # #
### ## # #
####.$ # #
###.$    #
###.$  ###
###.$  ###
##########