; 926
##########
#  @   ###
# $. $ ###
# $#######
## #######
#  #######
#  ##    #
#  ###.$ #
# .   .  #
##########