; 142
##########
#  $.#   #
#  $.# # #
#  $.# # #
#  $.  # #
#     ## #
## ###@# #
##       #
##########
##########