; 968
##########
#   ######
# .$######
# $  #####
#. . #####
##$$######
## @.#####
##########
##########
##########