; 96
##########
#    $.#.#
# ######$#
#    #.$ #
####.##  #
#   $    #
#        #
##  @ ####
##########
##########