; 251
##########
#   .$@###
# . $ .###
# $$######
# . ######
# ########
# ########
##########
##########
##########