; 184
##########
#      ###
# ####.###
# ##  $  #
# ##     #
#$#   @ ##
#.# ######
###  $.###
##.$    ##
##########