; 174
##########
######.$ #
#.$ @    #
#        #
#  ###$ ##
#  ###  ##
#   #. ###
#        #
##     $.#
##########