; 102
##########
##########
##  @ ####
#        #
#   $    #
####.##  #
#    #.$ #
# ######$#
#    $.#.#
##########