; 782
##########
#######  #
######   #
########.#
#####    #
##@$ .. .#
### $  $ #
#######$ #
#######  #
##########