; 118
##########
##########
#  .######
#$ $   $.#
#.       #
### ###  #
###. @ $ #
#####    #
##########
##########