; 259
##########
#.### .  #
#     $$ #
# $.# .$@#
# ########
# ########
##########
##########
##########
##########