; 688
##########
##   .   #
##@    $ #
##    ####
## .######
# $  . ###
#.  # $ ##
#####$  ##
#####    #
##########