; 16
##########
##  $.####
##.#######
# $  #####
# @  #####
##   #####
##   #####
##$ ######
##. $.####
##########