; 108
##########
#    #####
# $ .   ##
#  ##   .#
#  #    $#
#     @  #
##   #  $#
######$ .#
######. ##
##########