; 117
##########
#.$  $.#.#
#  #   #$#
#    ### #
#    ### #
##@ $. # #
###  # # #
###  # # #
###  #   #
##########