; 195
##########
# $.#   .#
#     $# #
# ##.  # #
# ##$  # #
#      # #
# .# # # #
# $# @   #
#  #     #
##########