; 162
##########
######  ##
###  @  ##
##       #
#.$  $   #
#   #.####
#   #    #
#   #### #
# $.#.$  #
##########