; 161
##########
###  #   #
#    # # #
#    # #$#
##@ $. #.#
##   #####
##      .#
### $   $#
####.    #
##########