; 75
##########
##########
##########
#.# ######
#$# ######
# #   .$ #
# .$@ #  #
###  #   #
###    $.#
##########