; 122
##########
##########
#   $.  .#
#$     #$#
#. $     #
### #   ##
###.#@  ##
###     ##
###     ##
##########