; 182
##########
#        #
###  ### #
####   # #
#..### # #
#$$    # #
#   ##@# #
#$$ #### #
#..      #
##########