; 49
##########
#    #.###
#    #$###
#.#  # ###
#$#@$. ###
# #  #####
#   ######
#   ######
#.$ ######
##########