; 573
##########
#    . . #
#  # $.$ #
####@$ $.#
#######  #
######## #
##########
##########
##########
##########