; 21
##########
#####   ##
####  # ##
###  ## ##
### ##   #
### #  $.#
### #  $.#
### ## $.#
#@     $.#
##########