; 5
##########
#.$ ######
#   ####.#
#    $.#$#
##   ### #
## @$. # #
##   # # #
###### # #
######   #
##########