; 133
##########
# .#.$   #
# $##### #
#      # #
#   #  # #
#      # #
# # @ $. #
#$#    ###
#.########
##########