; 35
##########
#    #   #
# ## # $$#
# #  # ..#
# # #  ###
# # #  ###
# # #   ##
#$# .$ @##
#.###   ##
##########