; 231
##########
#.########
#$## #####
# ## ### #
# ##  #  #
#  .$ @  #
#### #  $#
####    .#
#### $.###
##########