; 146
##########
##.$   ###
#     ####
# #.$  ###
# ###   .#
#    @  $#
#    ##  #
##  $  . #
###  #  ##
##########