; 25
##########
##@    ###
### ## ###
### #  $.#
### #$ $.#
#   #. $.#
# ####  ##
#     # ##
#####   ##
##########