; 148
##########
#      ###
# ####.###
#$#   $  #
#.#      #
### # @  #
#  #     #
#$ # ### #
#.    $. #
##########