; 857
##########
#     .###
# $   ####
#### #####
#### #####
###  #####
#### .   #
### $ $ ##
### . .$@#
##########