; 641
##########
##########
#  #######
# ########
# ###### #
#  ## #. #
# $ $.$$ #
#.    . @#
# ########
##########