; 169
##########
##.     ##
##$      #
##  ##   #
##@ ###  #
##  ##.  #
#.  $    #
#$    # $#
#   ### .#
##########