; 52
##########
##########
#.    $.##
#$ .     #
# # ##   #
#  $ @  $#
#       .#
##########
##########
##########