; 124
##########
#      ###
# ####.###
#$#   $  #
#.#      #
###  #@  #
#        #
# $.###  #
######.$ #
##########