; 836
##########
#  #######
# ########
#  #######
#.########
# ########
# ### # .#
#$$ $ .$ #
#.      @#
##########