; 2
##########
#.  ######
#$     ###
#    @ ###
###  $ ###
###$#.####
###.#    #
######## #
##.$     #
##########