; 14
##########
##########
##########
#        #
# $     $#
#  #    .#
#  # @ $##
# .    .##
#      $.#
##########