; 43
##########
#      ###
# #### ###
# #.$  ###
# ######.#
# #     $#
# .$@    #
###     $#
###     .#
##########