; 303
##########
### .    #
####$$ $@#
#.#   ## #
#     #. #
#    ##$ #
#  ####  #
# ########
#. #######
##########