; 147
##########
#        #
# ###### #
# #      #
# #@# ####
# ### #..#
#  ## #$$#
##       #
####.$ $.#
##########