; 355
##########
##########
##########
##########
##########
##########
######. ##
#  $@$  .#
#. $ .$  #
##########