; 11
##########
##.$    ##
##.$    ##
####    ##
#  .$@ ###
# ##   ###
# ##   #.#
# ######$#
#        #
######## #