; 846
##########
# #  #####
# #$ #####
# #@ #####
#  $######
# $.######
#.#. #####
# $. #####
#   ######
##########