; 574
##########
##########
##########
##     ###
###$$.$@##
## .#  ###
##.    ###
## $#   ##
#    . ###
##########