; 214
##########
#    .  ##
# $.$ ####
#  #######
# ########
#.########
#  #######
#$ # #####
#@$. #####
##########