; 582
##########
######.  #
####### $#
######   #
#######.$#
#######  #
####### .#
##### $$.#
##### @  #
##########