; 691
##########
######  ##
#        #
#     ####
# ########
# $ $.  .#
# .     ##
# ####$$ #
# ### @. #
##########