; 70
##########
#        #
#  ####  #
#   ###  #
#   #@#  #
#.$ # ## #
#.$ #    #
#.$ # ####
#.$   ####
##########