; 481
##########
##########
#######  #
######  ##
#### #$ .#
##   #  ##
##  @# $.#
## $$ .. #
#        #
##########