; 44
##########
###.$  ###
######.###
##### $  #
##### @  #
#####    #
#####    #
#####    #
####.$ $.#
##########