; 51
##########
###### $.#
#.####   #
#$####   #
# ###  # #
# # .$@#$#
# # #  #.#
# # #    #
#   #    #
##########