; 630
##########
##########
##########
##########
# ########
#   .. ###
# $$ .####
# $ # ####
#.   $@###
##########