; 983
##########
## ####  #
# @. .#  #
#.$$ ##  #
#  #  # .#
# ##  #$ #
#  # #   #
# $      #
####     #
##########