; 183
##########
# #####  #
#. ###   #
# $####  #
#  .###  #
#  $ ## .#
### .### #
##@$ ## $#
##       #
##########