; 87
##########
##########
##...##@##
##$$$## ##
##       #
##   ### #
## $.### #
## ##### #
##       #
##########