; 580
##########
##########
######  ##
# # #  ###
# $  $ ###
# $  . ###
# .#######
# ..$@####
#    #####
##########