; 86
##########
#.$ $.  .#
# @  #  $#
#        #
#  $ #   #
#   ###  #
##  .##  #
###      #
#        #
##########