; 851
##########
##       #
##      ##
# @#######
#  #######
## .   ###
## $ $$$ #
#####  ..#
####    .#
##########