; 145
##########
#      ###
#.#    ###
#$# @ $. #
# #    # #
#   #  # #
# ##   # #
#   #### #
#.$ #.$  #
##########